日期,管制站,入境 / 出境,香港居民,内地访客,其他访客,总计
2024-01-01,机场,入境,59647,4851,10011,74509
2024-01-01,机场,出境,19330,11546,30575,61451
2024-01-01,高铁西九龙,入境,33351,20492,874,54717
2024-01-01,高铁西九龙,出境,8865,41204,1542,51611
2024-01-01,红磡,入境,0,0,0,0
2024-01-01,红磡,出境,0,0,0,0
2024-01-01,罗湖,入境,85877,14525,539,100941
2024-01-01,罗湖,出境,38418,35087,731,74236
2024-01-01,落马洲支线,入境,62118,18061,318,80497
2024-01-01,落马洲支线,出境,32696,31652,491,64839
2024-01-01,香园围,入境,27986,4866,121,32973
2024-01-01,香园围,出境,15319,4367,62,19748
2024-01-01,港珠澳大桥,入境,46787,7415,4865,59067
2024-01-01,港珠澳大桥,出境,16729,11824,7061,35614
2024-01-01,落马洲,入境,22447,3117,249,25813
2024-01-01,落马洲,出境,9172,27459,617,37248
2024-01-01,文锦渡,入境,1468,431,6,1905
2024-01-01,文锦渡,出境,705,473,2,1180
2024-01-01,沙头角,入境,0,0,0,0
2024-01-01,沙头角,出境,0,0,0,0
2024-01-01,深圳湾,入境,46772,10538,718,58028
2024-01-01,深圳湾,出境,18491,18036,924,37451
2024-01-01,中国客运码头,入境,2661,812,193,3666
2024-01-01,中国客运码头,出境,539,1733,226,2498
2024-01-01,港口管制,入境,0,0,45,45
2024-01-01,港口管制,出境,0,0,16,16
2024-01-01,启德邮轮码头,入境,0,0,0,0
2024-01-01,启德邮轮码头,出境,0,2,1958,1960
2024-01-01,港澳客轮码头,入境,7465,1399,2626,11490
2024-01-01,港澳客轮码头,出境,3391,2074,3225,8690
2024-01-02,机场,入境,47450,6715,13580,67745
2024-01-02,机场,出境,23922,7870,27863,59655
2024-01-02,高铁西九龙,入境,20987,12054,1171,34212
2024-01-02,高铁西九龙,出境,10199,12478,1071,23748
2024-01-02,红磡,入境,0,0,0,0
2024-01-02,红磡,出境,0,0,0,0
2024-01-02,罗湖,入境,62591,11169,651,74411
2024-01-02,罗湖,出境,49425,11812,662,61899
2024-01-02,落马洲支线,入境,47776,11613,315,59704
2024-01-02,落马洲支线,出境,40693,10991,350,52034
2024-01-02,香园围,入境,21339,3795,103,25237
2024-01-02,香园围,出境,18962,2136,70,21168
2024-01-02,港珠澳大桥,入境,20803,4827,4720,30350
2024-01-02,港珠澳大桥,出境,15639,5983,4539,26161
2024-01-02,落马洲,入境,12520,2503,244,15267
2024-01-02,落马洲,出境,7365,3217,372,10954
2024-01-02,文锦渡,入境,1277,364,7,1648
2024-01-02,文锦渡,出境,1153,278,4,1435
2024-01-02,沙头角,入境,0,0,0,0
2024-01-02,沙头角,出境,0,0,0,0
2024-01-02,深圳湾,入境,28607,8672,780,38059
2024-01-02,深圳湾,出境,20679,8453,889,30021
2024-01-02,中国客运码头,入境,992,620,219,1831
2024-01-02,中国客运码头,出境,692,608,277,1577
2024-01-02,港口管制,入境,40,0,16,56
2024-01-02,港口管制,出境,0,1,19,20
2024-01-02,启德邮轮码头,入境,0,0,0,0
2024-01-02,启德邮轮码头,出境,0,0,0,0
2024-01-02,港澳客轮码头,入境,3661,896,2732,7289
2024-01-02,港澳客轮码头,出境,4282,1148,3280,8710
2024-01-03,机场,入境,36822,7505,16242,60569
2024-01-03,机场,出境,24330,6400,22206,52936
2024-01-03,高铁西九龙,入境,13193,12764,1190,27147
2024-01-03,高铁西九龙,出境,10002,10817,1017,21836
2024-01-03,红磡,入境,0,0,0,0
2024-01-03,红磡,出境,0,0,0,0
2024-01-03,罗湖,入境,55448,11294,590,67332
2024-01-03,罗湖,出境,52109,11987,683,64779
2024-01-03,落马洲支线,入境,44171,12320,287,56778
2024-01-03,落马洲支线,出境,43833,11754,322,55909
2024-01-03,香园围,入境,20228,4773,82,25083
2024-01-03,香园围,出境,20387,2447,116,22950
2024-01-03,港珠澳大桥,入境,16424,4730,4353,25507
2024-01-03,港珠澳大桥,出境,15861,6591,4170,26622
2024-01-03,落马洲,入境,9261,2279,230,11770
2024-01-03,落马洲,出境,7601,2882,400,10883
2024-01-03,文锦渡,入境,1384,334,9,1727
2024-01-03,文锦渡,出境,1376,261,9,1646
2024-01-03,沙头角,入境,0,0,0,0
2024-01-03,沙头角,出境,0,0,0,0
2024-01-03,深圳湾,入境,22857,9138,832,32827
2024-01-03,深圳湾,出境,20751,8384,986,30121
2024-01-03,中国客运码头,入境,616,644,232,1492
2024-01-03,中国客运码头,出境,557,537,193,1287
2024-01-03,港口管制,入境,0,0,57,57
2024-01-03,港口管制,出境,0,0,14,14
2024-01-03,启德邮轮码头,入境,1225,965,3527,5717
2024-01-03,启德邮轮码头,出境,1394,819,2443,4656
2024-01-03,港澳客轮码头,入境,4530,812,2645,7987
2024-01-03,港澳客轮码头,出境,4489,1110,2680,8279
2024-01-04,机场,入境,30057,6704,17216,53977
2024-01-04,机场,出境,25699,5186,16894,47779
2024-01-04,高铁西九龙,入境,11039,12164,1043,24246
2024-01-04,高铁西九龙,出境,10814,10735,1061,22610
2024-01-04,红磡,入境,0,0,0,0
2024-01-04,红磡,出境,0,0,0,0
2024-01-04,罗湖,入境,54240,11074,592,65906
2024-01-04,罗湖,出境,52823,12131,597,65551
2024-01-04,落马洲支线,入境,43766,12685,281,56732
2024-01-04,落马洲支线,出境,44675,12396,320,57391
2024-01-04,香园围,入境,20301,5131,70,25502
2024-01-04,香园围,出境,21028,2518,88,23634
2024-01-04,港珠澳大桥,入境,15604,4826,4103,24533
2024-01-04,港珠澳大桥,出境,15182,6056,3923,25161
2024-01-04,落马洲,入境,8867,2254,191,11312
2024-01-04,落马洲,出境,7370,3263,332,10965
2024-01-04,文锦渡,入境,1404,396,23,1823
2024-01-04,文锦渡,出境,1398,337,5,1740
2024-01-04,沙头角,入境,0,0,0,0
2024-01-04,沙头角,出境,0,0,0,0
2024-01-04,深圳湾,入境,22524,9205,789,32518
2024-01-04,深圳湾,出境,21987,8337,907,31231
2024-01-04,中国客运码头,入境,574,595,215,1384
2024-01-04,中国客运码头,出境,562,651,207,1420
2024-01-04,港口管制,入境,1,0,21,22
2024-01-04,港口管制,出境,1,0,24,25
2024-01-04,启德邮轮码头,入境,0,0,0,0
2024-01-04,启德邮轮码头,出境,0,0,623,623
2024-01-04,港澳客轮码头,入境,4588,829,2786,8203
2024-01-04,港澳客轮码头,出境,4168,1285,2604,8057
2024-01-05,机场,入境,29506,7050,17919,54475
2024-01-05,机场,出境,28070,6348,16889,51307
2024-01-05,高铁西九龙,入境,12150,12894,1098,26142
2024-01-05,高铁西九龙,出境,17115,11221,1044,29380
2024-01-05,红磡,入境,0,0,0,0
2024-01-05,红磡,出境,0,0,0,0
2024-01-05,罗湖,入境,56295,11763,532,68590
2024-01-05,罗湖,出境,64584,12970,631,78185
2024-01-05,落马洲支线,入境,45948,13767,364,60079
2024-01-05,落马洲支线,出境,54580,14053,328,68961
2024-01-05,香园围,入境,21123,5008,101,26232
2024-01-05,香园围,出境,23874,2901,97,26872
2024-01-05,港珠澳大桥,入境,16416,4943,3903,25262
2024-01-05,港珠澳大桥,出境,21857,7114,3654,32625
2024-01-05,落马洲,入境,9367,2446,246,12059
2024-01-05,落马洲,出境,9232,3221,314,12767
2024-01-05,文锦渡,入境,1332,393,12,1737
2024-01-05,文锦渡,出境,1570,367,13,1950
2024-01-05,沙头角,入境,0,0,0,0
2024-01-05,沙头角,出境,0,0,0,0
2024-01-05,深圳湾,入境,24589,9884,904,35377
2024-01-05,深圳湾,出境,29082,9719,858,39659
2024-01-05,中国客运码头,入境,778,628,271,1677
2024-01-05,中国客运码头,出境,951,597,202,1750
2024-01-05,港口管制,入境,0,0,28,28
2024-01-05,港口管制,出境,0,0,46,46
2024-01-05,启德邮轮码头,入境,953,784,72,1809
2024-01-05,启德邮轮码头,出境,1034,189,68,1291
2024-01-05,港澳客轮码头,入境,4689,929,2955,8573
2024-01-05,港澳客轮码头,出境,6420,1189,2739,10348
2024-01-06,机场,入境,33311,7237,16273,56821
2024-01-06,机场,出境,25796,6035,18362,50193
2024-01-06,高铁西九龙,入境,12731,24234,1149,38114
2024-01-06,高铁西九龙,出境,18048,16863,1012,35923
2024-01-06,红磡,入境,0,0,0,0
2024-01-06,红磡,出境,0,0,0,0
2024-01-06,罗湖,入境,64787,15983,604,81374
2024-01-06,罗湖,出境,83746,18361,625,102732
2024-01-06,落马洲支线,入境,53173,22496,393,76062
2024-01-06,落马洲支线,出境,70741,21150,363,92254
2024-01-06,香园围,入境,24282,6868,87,31237
2024-01-06,香园围,出境,30020,3446,75,33541
2024-01-06,港珠澳大桥,入境,20744,5608,5844,32196
2024-01-06,港珠澳大桥,出境,31085,8018,5031,44134
2024-01-06,落马洲,入境,13678,2829,340,16847
2024-01-06,落马洲,出境,13127,4499,300,17926
2024-01-06,文锦渡,入境,898,547,6,1451
2024-01-06,文锦渡,出境,1300,406,9,1715
2024-01-06,沙头角,入境,0,0,0,0
2024-01-06,沙头角,出境,0,0,0,0
2024-01-06,深圳湾,入境,28539,14958,907,44404
2024-01-06,深圳湾,出境,37160,12973,951,51084
2024-01-06,中国客运码头,入境,660,1041,261,1962
2024-01-06,中国客运码头,出境,1116,654,223,1993
2024-01-06,港口管制,入境,1,3,59,63
2024-01-06,港口管制,出境,0,0,12,12
2024-01-06,启德邮轮码头,入境,100,164,1919,2183
2024-01-06,启德邮轮码头,出境,5,177,11,193
2024-01-06,港澳客轮码头,入境,5161,957,3149,9267
2024-01-06,港澳客轮码头,出境,7646,1268,2788,11702
2024-01-07,机场,入境,38936,7287,14987,61210
2024-01-07,机场,出境,24984,8645,21244,54873
2024-01-07,高铁西九龙,入境,21231,20980,1205,43416
2024-01-07,高铁西九龙,出境,10446,19138,1131,30715
2024-01-07,红磡,入境,0,0,0,0
2024-01-07,红磡,出境,0,0,0,0
2024-01-07,罗湖,入境,86244,14089,668,101001
2024-01-07,罗湖,出境,60405,17667,701,78773
2024-01-07,落马洲支线,入境,67221,18620,344,86185
2024-01-07,落马洲支线,出境,51615,17982,352,69949
2024-01-07,香园围,入境,31487,8198,93,39778
2024-01-07,香园围,出境,25511,4167,77,29755
2024-01-07,港珠澳大桥,入境,34311,6465,5198,45974
2024-01-07,港珠澳大桥,出境,20407,8581,5775,34763
2024-01-07,落马洲,入境,19759,2742,271,22772
2024-01-07,落马洲,出境,10015,4098,362,14475
2024-01-07,文锦渡,入境,1325,430,11,1766
2024-01-07,文锦渡,出境,787,341,4,1132
2024-01-07,沙头角,入境,0,0,0,0
2024-01-07,沙头角,出境,0,0,0,0
2024-01-07,深圳湾,入境,42981,12587,830,56398
2024-01-07,深圳湾,出境,27920,12718,944,41582
2024-01-07,中国客运码头,入境,1303,834,206,2343
2024-01-07,中国客运码头,出境,554,738,260,1552
2024-01-07,港口管制,入境,0,0,77,77
2024-01-07,港口管制,出境,15,0,37,52
2024-01-07,启德邮轮码头,入境,1034,189,45,1268
2024-01-07,启德邮轮码头,出境,1585,330,1988,3903
2024-01-07,港澳客轮码头,入境,7859,851,2314,11024
2024-01-07,港澳客轮码头,出境,4806,1308,2700,8814
2024-01-08,机场,入境,29348,7256,16265,52869
2024-01-08,机场,出境,24500,6832,17871,49203
2024-01-08,高铁西九龙,入境,13198,15228,1038,29464
2024-01-08,高铁西九龙,出境,11163,12471,1018,24652
2024-01-08,红磡,入境,0,0,0,0
2024-01-08,红磡,出境,0,0,0,0
2024-01-08,罗湖,入境,60455,12935,639,74029
2024-01-08,罗湖,出境,55809,13568,661,70038
2024-01-08,落马洲支线,入境,48282,13313,322,61917
2024-01-08,落马洲支线,出境,47542,12281,355,60178
2024-01-08,香园围,入境,21422,6757,68,28247
2024-01-08,香园围,出境,21284,2942,93,24319
2024-01-08,港珠澳大桥,入境,18510,5202,3528,27240
2024-01-08,港珠澳大桥,出境,15926,8485,3284,27695
2024-01-08,落马洲,入境,11075,2960,257,14292
2024-01-08,落马洲,出境,8018,3176,451,11645
2024-01-08,文锦渡,入境,1465,448,8,1921
2024-01-08,文锦渡,出境,1381,330,8,1719
2024-01-08,沙头角,入境,0,0,0,0
2024-01-08,沙头角,出境,0,0,0,0
2024-01-08,深圳湾,入境,25886,9926,849,36661
2024-01-08,深圳湾,出境,23287,8718,1096,33101
2024-01-08,中国客运码头,入境,630,730,183,1543
2024-01-08,中国客运码头,出境,712,641,189,1542
2024-01-08,港口管制,入境,0,0,15,15
2024-01-08,港口管制,出境,1,0,44,45
2024-01-08,启德邮轮码头,入境,0,0,0,0
2024-01-08,启德邮轮码头,出境,0,0,0,0
2024-01-08,港澳客轮码头,入境,5343,844,2300,8487
2024-01-08,港澳客轮码头,出境,4427,1317,2253,7997
2024-01-09,机场,入境,24998,5995,14655,45648
2024-01-09,机场,出境,22197,6280,15204,43681
2024-01-09,高铁西九龙,入境,10586,14202,1059,25847
2024-01-09,高铁西九龙,出境,10761,12807,1108,24676
2024-01-09,红磡,入境,0,0,0,0
2024-01-09,红磡,出境,0,0,0,0
2024-01-09,罗湖,入境,55713,11942,564,68219
2024-01-09,罗湖,出境,55491,13541,636,69668
2024-01-09,落马洲支线,入境,45649,13280,322,59251
2024-01-09,落马洲支线,出境,46700,13002,305,60007
2024-01-09,香园围,入境,20973,5979,74,27026
2024-01-09,香园围,出境,21666,3668,80,25414
2024-01-09,港珠澳大桥,入境,15872,5591,3596,25059
2024-01-09,港珠澳大桥,出境,15185,8518,3314,27017
2024-01-09,落马洲,入境,9455,2548,217,12220
2024-01-09,落马洲,出境,7812,3292,340,11444
2024-01-09,文锦渡,入境,1359,403,7,1769
2024-01-09,文锦渡,出境,1386,344,7,1737
2024-01-09,沙头角,入境,0,0,0,0
2024-01-09,沙头角,出境,0,0,0,0
2024-01-09,深圳湾,入境,23213,9994,772,33979
2024-01-09,深圳湾,出境,22170,8784,946,31900
2024-01-09,中国客运码头,入境,563,700,177,1440
2024-01-09,中国客运码头,出境,597,684,182,1463
2024-01-09,港口管制,入境,0,0,49,49
2024-01-09,港口管制,出境,27,3,18,48
2024-01-09,启德邮轮码头,入境,0,0,0,0
2024-01-09,启德邮轮码头,出境,0,0,0,0
2024-01-09,港澳客轮码头,入境,3779,848,1670,6297
2024-01-09,港澳客轮码头,出境,4022,1417,2022,7461
2024-01-10,机场,入境,23985,6741,15272,45998
2024-01-10,机场,出境,24528,6549,15198,46275
2024-01-10,高铁西九龙,入境,11399,13194,1108,25701
2024-01-10,高铁西九龙,出境,10587,13349,1255,25191
2024-01-10,红磡,入境,0,0,0,0
2024-01-10,红磡,出境,0,0,0,0
2024-01-10,罗湖,入境,56287,12228,569,69084
2024-01-10,罗湖,出境,54761,13385,593,68739
2024-01-10,落马洲支线,入境,45644,14103,323,60070
2024-01-10,落马洲支线,出境,46241,13877,316,60434
2024-01-10,香园围,入境,20500,7132,111,27743
2024-01-10,香园围,出境,20663,3071,311,24045
2024-01-10,港珠澳大桥,入境,15252,5699,3414,24365
2024-01-10,港珠澳大桥,出境,15102,8113,3555,26770
2024-01-10,落马洲,入境,9415,2308,315,12038
2024-01-10,落马洲,出境,7711,3122,382,11215
2024-01-10,文锦渡,入境,1383,409,14,1806
2024-01-10,文锦渡,出境,1327,315,5,1647
2024-01-10,沙头角,入境,0,0,0,0
2024-01-10,沙头角,出境,0,0,0,0
2024-01-10,深圳湾,入境,23661,9793,950,34404
2024-01-10,深圳湾,出境,22499,8786,909,32194
2024-01-10,中国客运码头,入境,676,943,218,1837
2024-01-10,中国客运码头,出境,590,685,217,1492
2024-01-10,港口管制,入境,0,0,73,73
2024-01-10,港口管制,出境,19,0,52,71
2024-01-10,启德邮轮码头,入境,0,0,0,0
2024-01-10,启德邮轮码头,出境,0,0,0,0
2024-01-10,港澳客轮码头,入境,4323,970,2277,7570
2024-01-10,港澳客轮码头,出境,4258,1567,2164,7989
2024-01-11,机场,入境,22164,7499,16891,46554
2024-01-11,机场,出境,26278,6574,15241,48093
2024-01-11,高铁西九龙,入境,10629,13623,1130,25382
2024-01-11,高铁西九龙,出境,11361,15892,1286,28539
2024-01-11,红磡,入境,0,0,0,0
2024-01-11,红磡,出境,0,0,0,0
2024-01-11,罗湖,入境,55609,11477,600,67686
2024-01-11,罗湖,出境,56097,13620,640,70357
2024-01-11,落马洲支线,入境,45220,13248,383,58851
2024-01-11,落马洲支线,出境,47214,13237,319,60770
2024-01-11,香园围,入境,21286,6631,105,28022
2024-01-11,香园围,出境,22344,2704,81,25129
2024-01-11,港珠澳大桥,入境,15448,6120,3279,24847
2024-01-11,港珠澳大桥,出境,16651,10418,3616,30685
2024-01-11,落马洲,入境,9406,2197,372,11975
2024-01-11,落马洲,出境,7839,3129,349,11317
2024-01-11,文锦渡,入境,1396,399,10,1805
2024-01-11,文锦渡,出境,1404,344,16,1764
2024-01-11,沙头角,入境,0,0,0,0
2024-01-11,沙头角,出境,0,0,0,0
2024-01-11,深圳湾,入境,23095,9812,1198,34105
2024-01-11,深圳湾,出境,23496,9540,878,33914
2024-01-11,中国客运码头,入境,568,683,217,1468
2024-01-11,中国客运码头,出境,631,914,200,1745
2024-01-11,港口管制,入境,18,0,9,27
2024-01-11,港口管制,出境,0,1,26,27
2024-01-11,启德邮轮码头,入境,0,0,0,0
2024-01-11,启德邮轮码头,出境,0,0,0,0
2024-01-11,港澳客轮码头,入境,4396,991,2144,7531
2024-01-11,港澳客轮码头,出境,4540,1450,2196,8186
2024-01-12,机场,入境,23898,8960,17735,50593
2024-01-12,机场,出境,29083,7510,17099,53692
2024-01-12,高铁西九龙,入境,12635,16313,1399,30347
2024-01-12,高铁西九龙,出境,18840,13144,1019,33003
2024-01-12,红磡,入境,0,0,0,0
2024-01-12,红磡,出境,0,0,0,0
2024-01-12,罗湖,入境,59966,13096,701,73763
2024-01-12,罗湖,出境,70359,13867,655,84881
2024-01-12,落马洲支线,入境,48740,15144,441,64325
2024-01-12,落马洲支线,出境,59803,15112,306,75221
2024-01-12,香园围,入境,22188,5475,95,27758
2024-01-12,香园围,出境,25438,3431,65,28934
2024-01-12,港珠澳大桥,入境,16992,5978,3996,26966
2024-01-12,港珠澳大桥,出境,23918,9051,3613,36582
2024-01-12,落马洲,入境,10202,2614,695,13511
2024-01-12,落马洲,出境,10061,3589,332,13982
2024-01-12,文锦渡,入境,1414,437,38,1889
2024-01-12,文锦渡,出境,1694,414,7,2115
2024-01-12,沙头角,入境,0,0,0,0
2024-01-12,沙头角,出境,0,0,0,0
2024-01-12,深圳湾,入境,25919,11162,1717,38798
2024-01-12,深圳湾,出境,31566,10547,788,42901
2024-01-12,中国客运码头,入境,717,736,238,1691
2024-01-12,中国客运码头,出境,935,741,196,1872
2024-01-12,港口管制,入境,0,0,63,63
2024-01-12,港口管制,出境,0,1,33,34
2024-01-12,启德邮轮码头,入境,1510,316,142,1968
2024-01-12,启德邮轮码头,出境,1094,555,107,1756
2024-01-12,港澳客轮码头,入境,4735,1032,2491,8258
2024-01-12,港澳客轮码头,出境,5842,1393,2431,9666
2024-01-13,机场,入境,26255,8390,17994,52639
2024-01-13,机场,出境,25521,7021,15709,48251
2024-01-13,高铁西九龙,入境,13534,30343,1168,45045
2024-01-13,高铁西九龙,出境,19731,19731,976,40438
2024-01-13,红磡,入境,0,0,0,0
2024-01-13,红磡,出境,0,0,0,0
2024-01-13,罗湖,入境,71147,20152,682,91981
2024-01-13,罗湖,出境,94273,23742,714,118729
2024-01-13,落马洲支线,入境,58717,28644,446,87807
2024-01-13,落马洲支线,出境,83275,26482,420,110177
2024-01-13,香园围,入境,25695,8633,89,34417
2024-01-13,香园围,出境,34000,4791,104,38895
2024-01-13,港珠澳大桥,入境,20538,7606,6025,34169
2024-01-13,港珠澳大桥,出境,35996,9254,5298,50548
2024-01-13,落马洲,入境,14940,3393,424,18757
2024-01-13,落马洲,出境,14910,5997,304,21211
2024-01-13,文锦渡,入境,1013,709,15,1737
2024-01-13,文锦渡,出境,1661,517,9,2187
2024-01-13,沙头角,入境,0,0,0,0
2024-01-13,沙头角,出境,0,0,0,0
2024-01-13,深圳湾,入境,30432,18926,1043,50401
2024-01-13,深圳湾,出境,41283,16802,894,58979
2024-01-13,中国客运码头,入境,652,1210,247,2109
2024-01-13,中国客运码头,出境,1070,816,219,2105
2024-01-13,港口管制,入境,1,0,14,15
2024-01-13,港口管制,出境,5,0,29,34
2024-01-13,启德邮轮码头,入境,2,154,4,160
2024-01-13,启德邮轮码头,出境,3,152,6,161
2024-01-13,港澳客轮码头,入境,4632,1199,3349,9180
2024-01-13,港澳客轮码头,出境,7970,1712,2880,12562
2024-01-14,机场,入境,34095,8248,16421,58764
2024-01-14,机场,出境,22824,9676,20798,53298
2024-01-14,高铁西九龙,入境,24393,19710,914,45017
2024-01-14,高铁西九龙,出境,12370,24396,1270,38036
2024-01-14,红磡,入境,0,0,0,0
2024-01-14,红磡,出境,0,0,0,0
2024-01-14,罗湖,入境,102096,15930,665,118691
2024-01-14,罗湖,出境,70606,21100,740,92446
2024-01-14,落马洲支线,入境,81256,21693,344,103293
2024-01-14,落马洲支线,出境,60943,22233,401,83577
2024-01-14,香园围,入境,36386,9139,88,45613
2024-01-14,香园围,出境,28456,4799,98,33353
2024-01-14,港珠澳大桥,入境,43387,6561,4933,54881
2024-01-14,港珠澳大桥,出境,26701,9020,6074,41795
2024-01-14,落马洲,入境,23686,2628,300,26614
2024-01-14,落马洲,出境,11112,4286,765,16163
2024-01-14,文锦渡,入境,1528,589,18,2135
2024-01-14,文锦渡,出境,920,432,5,1357
2024-01-14,沙头角,入境,0,0,0,0
2024-01-14,沙头角,出境,0,0,0,0
2024-01-14,深圳湾,入境,50993,13847,812,65652
2024-01-14,深圳湾,出境,32859,14985,1491,49335
2024-01-14,中国客运码头,入境,1515,872,150,2537
2024-01-14,中国客运码头,出境,605,1227,195,2027
2024-01-14,港口管制,入境,0,2,57,59
2024-01-14,港口管制,出境,0,0,43,43
2024-01-14,启德邮轮码头,入境,1093,555,52,1700
2024-01-14,启德邮轮码头,出境,860,1007,121,1988
2024-01-14,港澳客轮码头,入境,8574,1093,2083,11750
2024-01-14,港澳客轮码头,出境,6135,1754,2545,10434
2024-01-15,机场,入境,29107,9368,16505,54980
2024-01-15,机场,出境,22291,7710,16582,46583
2024-01-15,高铁西九龙,入境,14595,16105,946,31646
2024-01-15,高铁西九龙,出境,11513,13043,1203,25759
2024-01-15,红磡,入境,0,0,0,0
2024-01-15,红磡,出境,0,0,0,0
2024-01-15,罗湖,入境,64237,13911,585,78733
2024-01-15,罗湖,出境,58937,14425,738,74100
2024-01-15,落马洲支线,入境,51545,14062,303,65910
2024-01-15,落马洲支线,出境,49248,12795,417,62460
2024-01-15,香园围,入境,22701,6191,88,28980
2024-01-15,香园围,出境,22394,3129,143,25666
2024-01-15,港珠澳大桥,入境,22410,6219,3512,32141
2024-01-15,港珠澳大桥,出境,16183,9475,3438,29096
2024-01-15,落马洲,入境,11697,3516,245,15458
2024-01-15,落马洲,出境,8061,3462,636,12159
2024-01-15,文锦渡,入境,1466,484,23,1973
2024-01-15,文锦渡,出境,1560,382,17,1959
2024-01-15,沙头角,入境,0,0,0,0
2024-01-15,沙头角,出境,0,0,0,0
2024-01-15,深圳湾,入境,27015,11907,717,39639
2024-01-15,深圳湾,出境,24843,11708,1410,37961
2024-01-15,中国客运码头,入境,690,785,236,1711
2024-01-15,中国客运码头,出境,693,745,248,1686
2024-01-15,港口管制,入境,30,2,21,53
2024-01-15,港口管制,出境,32,0,27,59
2024-01-15,启德邮轮码头,入境,0,0,0,0
2024-01-15,启德邮轮码头,出境,0,0,0,0
2024-01-15,港澳客轮码头,入境,5877,1064,2115,9056
2024-01-15,港澳客轮码头,出境,4302,1532,2319,8153
2024-01-16,机场,入境,24117,8093,15456,47666
2024-01-16,机场,出境,19570,7356,16245,43171
2024-01-16,高铁西九龙,入境,12249,15061,1047,28357
2024-01-16,高铁西九龙,出境,10968,13807,1012,25787
2024-01-16,红磡,入境,0,0,0,0
2024-01-16,红磡,出境,0,0,0,0
2024-01-16,罗湖,入境,59248,13098,587,72933
2024-01-16,罗湖,出境,57715,14552,694,72961
2024-01-16,落马洲支线,入境,46987,14926,347,62260
2024-01-16,落马洲支线,出境,47754,14304,364,62422
2024-01-16,香园围,入境,21296,6553,243,28092
2024-01-16,香园围,出境,21186,2981,129,24296
2024-01-16,港珠澳大桥,入境,16210,6758,3538,26506
2024-01-16,港珠澳大桥,出境,15833,9825,3706,29364
2024-01-16,落马洲,入境,9705,2823,296,12824
2024-01-16,落马洲,出境,7895,3343,427,11665
2024-01-16,文锦渡,入境,1419,500,13,1932
2024-01-16,文锦渡,出境,1391,388,8,1787
2024-01-16,沙头角,入境,0,0,0,0
2024-01-16,沙头角,出境,0,0,0,0
2024-01-16,深圳湾,入境,24846,11241,857,36944
2024-01-16,深圳湾,出境,23359,10665,1104,35128
2024-01-16,中国客运码头,入境,615,799,172,1586
2024-01-16,中国客运码头,出境,631,844,163,1638
2024-01-16,港口管制,入境,0,0,34,34
2024-01-16,港口管制,出境,2,2,39,43
2024-01-16,启德邮轮码头,入境,0,0,0,0
2024-01-16,启德邮轮码头,出境,0,0,0,0
2024-01-16,港澳客轮码头,入境,4372,1011,2151,7534
2024-01-16,港澳客轮码头,出境,4100,1706,2237,8043
2024-01-17,机场,入境,23696,9221,16488,49405
2024-01-17,机场,出境,21744,7451,14819,44014
2024-01-17,高铁西九龙,入境,11301,15896,1084,28281
2024-01-17,高铁西九龙,出境,11872,13395,1030,26297
2024-01-17,红磡,入境,0,0,0,0
2024-01-17,红磡,出境,0,0,0,0
2024-01-17,罗湖,入境,57821,13959,605,72385
2024-01-17,罗湖,出境,57287,14984,677,72948
2024-01-17,落马洲支线,入境,46677,15527,322,62526
2024-01-17,落马洲支线,出境,48255,15041,349,63645
2024-01-17,香园围,入境,21212,6444,110,27766
2024-01-17,香园围,出境,22198,3160,101,25459
2024-01-17,港珠澳大桥,入境,15637,6467,3826,25930
2024-01-17,港珠澳大桥,出境,15868,10376,3903,30147
2024-01-17,落马洲,入境,9581,2461,303,12345
2024-01-17,落马洲,出境,7821,3074,432,11327
2024-01-17,文锦渡,入境,1412,438,16,1866
2024-01-17,文锦渡,出境,1366,417,10,1793
2024-01-17,沙头角,入境,0,0,0,0
2024-01-17,沙头角,出境,0,0,0,0
2024-01-17,深圳湾,入境,24560,10979,902,36441
2024-01-17,深圳湾,出境,23712,9910,878,34500
2024-01-17,中国客运码头,入境,642,895,184,1721
2024-01-17,中国客运码头,出境,800,892,187,1879
2024-01-17,港口管制,入境,0,0,72,72
2024-01-17,港口管制,出境,4,3,61,68
2024-01-17,启德邮轮码头,入境,858,1003,114,1975
2024-01-17,启德邮轮码头,出境,1135,443,35,1613
2024-01-17,港澳客轮码头,入境,4160,1194,2422,7776
2024-01-17,港澳客轮码头,出境,4149,2023,2520,8692
2024-01-18,机场,入境,20882,9047,18415,48344
2024-01-18,机场,出境,24780,7703,14516,46999
2024-01-18,高铁西九龙,入境,11663,16995,1090,29748
2024-01-18,高铁西九龙,出境,12401,14384,962,27747
2024-01-18,红磡,入境,0,0,0,0
2024-01-18,红磡,出境,0,0,0,0
2024-01-18,罗湖,入境,58718,13649,645,73012
2024-01-18,罗湖,出境,59820,15799,631,76250
2024-01-18,落马洲支线,入境,47195,15819,370,63384
2024-01-18,落马洲支线,出境,49781,15445,314,65540
2024-01-18,香园围,入境,21942,8671,123,30736
2024-01-18,香园围,出境,23113,3232,118,26463
2024-01-18,港珠澳大桥,入境,16190,6637,3782,26609
2024-01-18,港珠澳大桥,出境,17578,10111,3762,31451
2024-01-18,落马洲,入境,9693,3014,375,13082
2024-01-18,落马洲,出境,7932,3913,400,12245
2024-01-18,文锦渡,入境,1430,464,14,1908
2024-01-18,文锦渡,出境,1229,409,42,1680
2024-01-18,沙头角,入境,0,0,0,0
2024-01-18,沙头角,出境,0,0,0,0
2024-01-18,深圳湾,入境,24431,12264,957,37652
2024-01-18,深圳湾,出境,25350,11539,802,37691
2024-01-18,中国客运码头,入境,614,946,337,1897
2024-01-18,中国客运码头,出境,666,866,295,1827
2024-01-18,港口管制,入境,32,0,78,110
2024-01-18,港口管制,出境,21,0,32,53
2024-01-18,启德邮轮码头,入境,0,0,0,0
2024-01-18,启德邮轮码头,出境,0,0,0,0
2024-01-18,港澳客轮码头,入境,3480,1171,2203,6854
2024-01-18,港澳客轮码头,出境,4254,1725,2110,8089
2024-01-19,机场,入境,22969,11114,20191,54274
2024-01-19,机场,出境,27882,9014,16351,53247
2024-01-19,高铁西九龙,入境,13543,18198,1530,33271
2024-01-19,高铁西九龙,出境,19494,14992,921,35407
2024-01-19,红磡,入境,0,0,0,0
2024-01-19,红磡,出境,0,0,0,0
2024-01-19,罗湖,入境,62735,14452,629,77816
2024-01-19,罗湖,出境,73411,16029,684,90124
2024-01-19,落马洲支线,入境,49986,15803,403,66192
2024-01-19,落马洲支线,出境,62321,14966,337,77624
2024-01-19,香园围,入境,23048,5995,132,29175
2024-01-19,香园围,出境,26801,6108,297,33206
2024-01-19,港珠澳大桥,入境,18255,6651,4359,29265
2024-01-19,港珠澳大桥,出境,26121,9629,4054,39804
2024-01-19,落马洲,入境,10966,2948,549,14463
2024-01-19,落马洲,出境,10590,3718,344,14652
2024-01-19,文锦渡,入境,1351,477,6,1834
2024-01-19,文锦渡,出境,1655,395,8,2058
2024-01-19,沙头角,入境,0,0,0,0
2024-01-19,沙头角,出境,0,0,0,0
2024-01-19,深圳湾,入境,28442,12491,1217,42150
2024-01-19,深圳湾,出境,34095,11767,738,46600
2024-01-19,中国客运码头,入境,951,911,329,2191
2024-01-19,中国客运码头,出境,1187,1002,369,2558
2024-01-19,港口管制,入境,16,0,71,87
2024-01-19,港口管制,出境,36,2,43,81
2024-01-19,启德邮轮码头,入境,1135,426,35,1596
2024-01-19,启德邮轮码头,出境,1399,363,53,1815
2024-01-19,港澳客轮码头,入境,4794,1291,3026,9111
2024-01-19,港澳客轮码头,出境,6265,1941,2848,11054
2024-01-20,机场,入境,24648,11701,18384,54733
2024-01-20,机场,出境,24496,9997,16940,51433
2024-01-20,高铁西九龙,入境,13653,31957,1334,46944
2024-01-20,高铁西九龙,出境,21157,20925,913,42995
2024-01-20,红磡,入境,0,0,0,0
2024-01-20,红磡,出境,0,0,0,0
2024-01-20,罗湖,入境,75262,22599,793,98654
2024-01-20,罗湖,出境,102359,25486,829,128674
2024-01-20,落马洲支线,入境,61549,31513,517,93579
2024-01-20,落马洲支线,出境,86880,29013,500,116393
2024-01-20,香园围,入境,27458,9312,117,36887
2024-01-20,香园围,出境,35946,4918,91,40955
2024-01-20,港珠澳大桥,入境,23612,8283,6873,38768
2024-01-20,港珠澳大桥,出境,39053,11078,5621,55752
2024-01-20,落马洲,入境,15667,3655,477,19799
2024-01-20,落马洲,出境,15703,4976,350,21029
2024-01-20,文锦渡,入境,1024,679,8,1711
2024-01-20,文锦渡,出境,1635,557,5,2197
2024-01-20,沙头角,入境,0,0,0,0
2024-01-20,沙头角,出境,0,0,0,0
2024-01-20,深圳湾,入境,33416,21416,1437,56269
2024-01-20,深圳湾,出境,44437,16946,922,62305
2024-01-20,中国客运码头,入境,708,1317,238,2263
2024-01-20,中国客运码头,出境,1373,1133,225,2731
2024-01-20,港口管制,入境,0,0,87,87
2024-01-20,港口管制,出境,0,0,79,79
2024-01-20,启德邮轮码头,入境,17,0,525,542
2024-01-20,启德邮轮码头,出境,6,0,601,607
2024-01-20,港澳客轮码头,入境,4974,1415,3358,9747
2024-01-20,港澳客轮码头,出境,8263,1775,2960,12998
2024-01-21,机场,入境,31279,11386,16040,58705
2024-01-21,机场,出境,21015,12401,21758,55174
2024-01-21,高铁西九龙,入境,24085,27962,1058,53105
2024-01-21,高铁西九龙,出境,11726,25506,1279,38511
2024-01-21,红磡,入境,0,0,0,0
2024-01-21,红磡,出境,0,0,0,0
2024-01-21,罗湖,入境,105417,20952,691,127060
2024-01-21,罗湖,出境,70202,25556,751,96509
2024-01-21,落马洲支线,入境,82516,27126,458,110100
2024-01-21,落马洲支线,出境,61049,26349,432,87830
2024-01-21,香园围,入境,35893,9935,85,45913
2024-01-21,香园围,出境,26610,4777,82,31469
2024-01-21,港珠澳大桥,入境,43606,9561,5922,59089
2024-01-21,港珠澳大桥,出境,23826,11037,7164,42027
2024-01-21,落马洲,入境,24529,3651,342,28522
2024-01-21,落马洲,出境,11442,4413,465,16320
2024-01-21,文锦渡,入境,1583,701,13,2297
2024-01-21,文锦渡,出境,963,476,13,1452
2024-01-21,沙头角,入境,0,0,0,0
2024-01-21,沙头角,出境,0,0,0,0
2024-01-21,深圳湾,入境,53187,17582,1002,71771
2024-01-21,深圳湾,出境,32725,16926,1165,50816
2024-01-21,中国客运码头,入境,1530,1340,190,3060
2024-01-21,中国客运码头,出境,738,1362,366,2466
2024-01-21,港口管制,入境,27,2,69,98
2024-01-21,港口管制,出境,1,0,58,59
2024-01-21,启德邮轮码头,入境,1399,368,32,1799
2024-01-21,启德邮轮码头,出境,954,562,114,1630
2024-01-21,港澳客轮码头,入境,7903,1489,2494,11886
2024-01-21,港澳客轮码头,出境,5555,2149,3095,10799
2024-01-22,机场,入境,25297,11228,16100,52625
2024-01-22,机场,出境,20962,10873,18343,50178
2024-01-22,高铁西九龙,入境,14749,22003,960,37712
2024-01-22,高铁西九龙,出境,10708,16806,1049,28563
2024-01-22,红磡,入境,0,0,0,0
2024-01-22,红磡,出境,0,0,0,0
2024-01-22,罗湖,入境,64306,16393,633,81332
2024-01-22,罗湖,出境,57387,16999,709,75095
2024-01-22,落马洲支线,入境,50857,17224,362,68443
2024-01-22,落马洲支线,出境,47635,14607,379,62621
2024-01-22,香园围,入境,22084,7322,106,29512
2024-01-22,香园围,出境,21245,3555,89,24889
2024-01-22,港珠澳大桥,入境,22459,8602,4105,35166
2024-01-22,港珠澳大桥,出境,15558,11672,4301,31531
2024-01-22,落马洲,入境,12044,3841,323,16208
2024-01-22,落马洲,出境,8187,6355,494,15036
2024-01-22,文锦渡,入境,1472,547,2,2021
2024-01-22,文锦渡,出境,1369,373,12,1754
2024-01-22,沙头角,入境,0,0,0,0
2024-01-22,沙头角,出境,0,0,0,0
2024-01-22,深圳湾,入境,28317,14301,877,43495
2024-01-22,深圳湾,出境,24078,12093,1049,37220
2024-01-22,中国客运码头,入境,850,1153,225,2228
2024-01-22,中国客运码头,出境,832,1181,331,2344
2024-01-22,港口管制,入境,8,0,11,19
2024-01-22,港口管制,出境,3,4,26,33
2024-01-22,启德邮轮码头,入境,0,0,0,0
2024-01-22,启德邮轮码头,出境,0,0,0,0
2024-01-22,港澳客轮码头,入境,6241,1456,2472,10169
2024-01-22,港澳客轮码头,出境,4144,2188,2391,8723
2024-01-23,机场,入境,22507,11229,15154,48890
2024-01-23,机场,出境,18135,10875,16499,45509
2024-01-23,高铁西九龙,入境,11684,18248,1063,30995
2024-01-23,高铁西九龙,出境,10163,15736,925,26824
2024-01-23,红磡,入境,0,0,0,0
2024-01-23,红磡,出境,0,0,0,0
2024-01-23,罗湖,入境,49797,12174,562,62533
2024-01-23,罗湖,出境,48319,13591,600,62510
2024-01-23,落马洲支线,入境,40259,13320,322,53901
2024-01-23,落马洲支线,出境,40144,12664,298,53106
2024-01-23,香园围,入境,15966,6381,95,22442
2024-01-23,香园围,出境,15801,2754,82,18637
2024-01-23,港珠澳大桥,入境,13344,8013,3084,24441
2024-01-23,港珠澳大桥,出境,12440,11327,3520,27287
2024-01-23,落马洲,入境,8548,2884,284,11716
2024-01-23,落马洲,出境,7228,4977,372,12577
2024-01-23,文锦渡,入境,1179,374,15,1568
2024-01-23,文锦渡,出境,1352,328,15,1695
2024-01-23,沙头角,入境,0,0,0,0
2024-01-23,沙头角,出境,0,0,0,0
2024-01-23,深圳湾,入境,21239,11273,924,33436
2024-01-23,深圳湾,出境,19540,10017,885,30442
2024-01-23,中国客运码头,入境,695,865,165,1725
2024-01-23,中国客运码头,出境,610,1224,191,2025
2024-01-23,港口管制,入境,1,0,34,35
2024-01-23,港口管制,出境,0,0,30,30
2024-01-23,启德邮轮码头,入境,0,0,0,0
2024-01-23,启德邮轮码头,出境,0,0,0,0
2024-01-23,港澳客轮码头,入境,3637,1280,1959,6876
2024-01-23,港澳客轮码头,出境,3379,2280,2064,7723
2024-01-24,机场,入境,21041,11189,16145,48375
2024-01-24,机场,出境,21068,11122,15365,47555
2024-01-24,高铁西九龙,入境,10761,18435,1017,30213
2024-01-24,高铁西九龙,出境,10191,16475,886,27552
2024-01-24,红磡,入境,0,0,0,0
2024-01-24,红磡,出境,0,0,0,0
2024-01-24,罗湖,入境,51916,13539,563,66018
2024-01-24,罗湖,出境,51002,15054,565,66621
2024-01-24,落马洲支线,入境,41574,14957,347,56878
2024-01-24,落马洲支线,出境,42989,13899,344,57232
2024-01-24,香园围,入境,16715,6274,107,23096
2024-01-24,香园围,出境,16626,3103,107,19836
2024-01-24,港珠澳大桥,入境,13375,8218,3648,25241
2024-01-24,港珠澳大桥,出境,13109,12299,3554,28962
2024-01-24,落马洲,入境,8496,2922,407,11825
2024-01-24,落马洲,出境,7458,4807,388,12653
2024-01-24,文锦渡,入境,1273,384,12,1669
2024-01-24,文锦渡,出境,1276,312,12,1600
2024-01-24,沙头角,入境,0,0,0,0
2024-01-24,沙头角,出境,0,0,0,0
2024-01-24,深圳湾,入境,21554,11766,913,34233
2024-01-24,深圳湾,出境,21104,10862,741,32707
2024-01-24,中国客运码头,入境,564,939,141,1644
2024-01-24,中国客运码头,出境,626,1152,307,2085
2024-01-24,港口管制,入境,0,0,28,28
2024-01-24,港口管制,出境,0,0,40,40
2024-01-24,启德邮轮码头,入境,0,0,0,0
2024-01-24,启德邮轮码头,出境,0,0,0,0
2024-01-24,港澳客轮码头,入境,3521,1475,2152,7148
2024-01-24,港澳客轮码头,出境,3431,2873,2211,8515
2024-01-25,机场,入境,19078,11639,19263,49980
2024-01-25,机场,出境,24450,11302,15163,50915
2024-01-25,高铁西九龙,入境,10687,21181,1109,32977
2024-01-25,高铁西九龙,出境,11803,17077,907,29787
2024-01-25,红磡,入境,0,0,0,0
2024-01-25,红磡,出境,0,0,0,0
2024-01-25,罗湖,入境,54184,15382,669,70235
2024-01-25,罗湖,出境,54829,16948,656,72433
2024-01-25,落马洲支线,入境,44544,16543,358,61445
2024-01-25,落马洲支线,出境,46005,15537,319,61861
2024-01-25,香园围,入境,19025,6757,126,25908
2024-01-25,香园围,出境,19529,3437,58,23024
2024-01-25,港珠澳大桥,入境,13778,9152,3692,26622
2024-01-25,港珠澳大桥,出境,14848,12906,3526,31280
2024-01-25,落马洲,入境,9322,3146,462,12930
2024-01-25,落马洲,出境,8032,3624,368,12024
2024-01-25,文锦渡,入境,1451,529,19,1999
2024-01-25,文锦渡,出境,1508,454,17,1979
2024-01-25,沙头角,入境,0,0,0,0
2024-01-25,沙头角,出境,0,0,0,0
2024-01-25,深圳湾,入境,22556,13420,1113,37089
2024-01-25,深圳湾,出境,23619,11593,750,35962
2024-01-25,中国客运码头,入境,599,1135,238,1972
2024-01-25,中国客运码头,出境,619,1181,316,2116
2024-01-25,港口管制,入境,0,0,32,32
2024-01-25,港口管制,出境,1,0,30,31
2024-01-25,启德邮轮码头,入境,0,0,0,0
2024-01-25,启德邮轮码头,出境,0,0,0,0
2024-01-25,港澳客轮码头,入境,3735,1577,2487,7799
2024-01-25,港澳客轮码头,出境,4084,2931,2398,9413
2024-01-26,机场,入境,20852,12240,20472,53564
2024-01-26,机场,出境,26917,12719,16624,56260
2024-01-26,高铁西九龙,入境,12204,23044,1194,36442
2024-01-26,高铁西九龙,出境,19552,18823,861,39236
2024-01-26,红磡,入境,0,0,0,0
2024-01-26,红磡,出境,0,0,0,0
2024-01-26,罗湖,入境,58478,17156,717,76351
2024-01-26,罗湖,出境,71698,19620,631,91949
2024-01-26,落马洲支线,入境,47380,18480,437,66297
2024-01-26,落马洲支线,出境,59097,18124,342,77563
2024-01-26,香园围,入境,21320,7675,138,29133
2024-01-26,香园围,出境,24626,4400,127,29153
2024-01-26,港珠澳大桥,入境,16598,8788,4529,29915
2024-01-26,港珠澳大桥,出境,24284,13035,4369,41688
2024-01-26,落马洲,入境,10202,3478,534,14214
2024-01-26,落马洲,出境,10336,5814,321,16471
2024-01-26,文锦渡,入境,1508,608,22,2138
2024-01-26,文锦渡,出境,1617,468,10,2095
2024-01-26,沙头角,入境,0,0,0,0
2024-01-26,沙头角,出境,0,0,0,0
2024-01-26,深圳湾,入境,26066,15191,1350,42607
2024-01-26,深圳湾,出境,33992,13662,824,48478
2024-01-26,中国客运码头,入境,705,1218,270,2193
2024-01-26,中国客运码头,出境,1129,1417,224,2770
2024-01-26,港口管制,入境,0,0,50,50
2024-01-26,港口管制,出境,1,2,33,36
2024-01-26,启德邮轮码头,入境,956,556,106,1618
2024-01-26,启德邮轮码头,出境,1342,392,101,1835
2024-01-26,港澳客轮码头,入境,4265,1811,2979,9055
2024-01-26,港澳客轮码头,出境,5992,2848,2595,11435
2024-01-27,机场,入境,22095,14187,17753,54035
2024-01-27,机场,出境,23847,13492,17588,54927
2024-01-27,高铁西九龙,入境,12156,35412,1184,48752
2024-01-27,高铁西九龙,出境,20049,23589,799,44437
2024-01-27,红磡,入境,0,0,0,0
2024-01-27,红磡,出境,0,0,0,0
2024-01-27,罗湖,入境,71874,24137,700,96711
2024-01-27,罗湖,出境,95604,27694,772,124070
2024-01-27,落马洲支线,入境,58014,31766,541,90321
2024-01-27,落马洲支线,出境,81371,28908,493,110772
2024-01-27,香园围,入境,25806,9338,111,35255
2024-01-27,香园围,出境,33160,5087,71,38318
2024-01-27,港珠澳大桥,入境,21489,9885,6766,38140
2024-01-27,港珠澳大桥,出境,34490,12677,5651,52818
2024-01-27,落马洲,入境,14893,4041,473,19407
2024-01-27,落马洲,出境,15172,7848,328,23348
2024-01-27,文锦渡,入境,993,840,13,1846
2024-01-27,文锦渡,出境,1564,653,7,2224
2024-01-27,沙头角,入境,0,0,0,0
2024-01-27,沙头角,出境,0,0,0,0
2024-01-27,深圳湾,入境,31527,23501,1351,56379
2024-01-27,深圳湾,出境,42592,19223,849,62664
2024-01-27,中国客运码头,入境,634,1565,214,2413
2024-01-27,中国客运码头,出境,1309,1352,351,3012
2024-01-27,港口管制,入境,1,0,131,132
2024-01-27,港口管制,出境,39,0,54,93
2024-01-27,启德邮轮码头,入境,188,303,2582,3073
2024-01-27,启德邮轮码头,出境,152,307,2688,3147
2024-01-27,港澳客轮码头,入境,4789,1833,3159,9781
2024-01-27,港澳客轮码头,出境,7141,2653,2881,12675
2024-01-28,机场,入境,29198,13870,14748,57816
2024-01-28,机场,出境,20933,14526,23558,59017
2024-01-28,高铁西九龙,入境,24361,31664,1039,57064
2024-01-28,高铁西九龙,出境,12178,27520,985,40683
2024-01-28,红磡,入境,0,0,0,0
2024-01-28,红磡,出境,0,0,0,0
2024-01-28,罗湖,入境,98351,22496,689,121536
2024-01-28,罗湖,出境,68740,27982,662,97384
2024-01-28,落马洲支线,入境,77165,27784,493,105442
2024-01-28,落马洲支线,出境,57495,26950,368,84813
2024-01-28,香园围,入境,33507,10523,127,44157
2024-01-28,香园围,出境,24609,5054,74,29737
2024-01-28,港珠澳大桥,入境,38703,10492,5889,55084
2024-01-28,港珠澳大桥,出境,21228,12958,7068,41254
2024-01-28,落马洲,入境,22494,3973,389,26856
2024-01-28,落马洲,出境,11089,8504,391,19984
2024-01-28,文锦渡,入境,1539,888,16,2443
2024-01-28,文锦渡,出境,964,665,11,1640
2024-01-28,沙头角,入境,0,0,0,0
2024-01-28,沙头角,出境,0,0,0,0
2024-01-28,深圳湾,入境,49573,20382,1103,71058
2024-01-28,深圳湾,出境,30672,19551,986,51209
2024-01-28,中国客运码头,入境,1556,1774,227,3557
2024-01-28,中国客运码头,出境,565,1772,319,2656
2024-01-28,港口管制,入境,0,0,55,55
2024-01-28,港口管制,出境,6,0,51,57
2024-01-28,启德邮轮码头,入境,1342,392,50,1784
2024-01-28,启德邮轮码头,出境,987,722,56,1765
2024-01-28,港澳客轮码头,入境,7519,1753,2547,11819
2024-01-28,港澳客轮码头,出境,4380,2771,2984,10135
2024-01-29,机场,入境,24559,14146,13733,52438
2024-01-29,机场,出境,18904,12354,19378,50636
2024-01-29,高铁西九龙,入境,14297,24831,999,40127
2024-01-29,高铁西九龙,出境,11709,20144,879,32732
2024-01-29,红磡,入境,0,0,0,0
2024-01-29,红磡,出境,0,0,0,0
2024-01-29,罗湖,入境,63455,18409,665,82529
2024-01-29,罗湖,出境,60055,20092,597,80744
2024-01-29,落马洲支线,入境,49988,18207,372,68567
2024-01-29,落马洲支线,出境,48309,16557,356,65222
2024-01-29,香园围,入境,21323,8717,122,30162
2024-01-29,香园围,出境,21120,3673,71,24864
2024-01-29,港珠澳大桥,入境,18674,9831,3748,32253
2024-01-29,港珠澳大桥,出境,15449,13327,3867,32643
2024-01-29,落马洲,入境,11725,3602,321,15648
2024-01-29,落马洲,出境,8271,6638,302,15211
2024-01-29,文锦渡,入境,1476,584,12,2072
2024-01-29,文锦渡,出境,1432,494,11,1937
2024-01-29,沙头角,入境,0,0,0,0
2024-01-29,沙头角,出境,0,0,0,0
2024-01-29,深圳湾,入境,27081,15272,923,43276
2024-01-29,深圳湾,出境,24447,14083,787,39317
2024-01-29,中国客运码头,入境,789,1378,160,2327
2024-01-29,中国客运码头,出境,792,1241,292,2325
2024-01-29,港口管制,入境,0,4,21,25
2024-01-29,港口管制,出境,4,0,42,46
2024-01-29,启德邮轮码头,入境,0,0,0,0
2024-01-29,启德邮轮码头,出境,0,0,0,0
2024-01-29,港澳客轮码头,入境,4853,2123,2284,9260
2024-01-29,港澳客轮码头,出境,4138,2844,2270,9252
2024-01-30,机场,入境,22043,13190,11701,46934
2024-01-30,机场,出境,17291,13385,17708,48384
2024-01-30,高铁西九龙,入境,11150,20814,872,32836
2024-01-30,高铁西九龙,出境,11304,20088,802,32194
2024-01-30,红磡,入境,0,0,0,0
2024-01-30,红磡,出境,0,0,0,0
2024-01-30,罗湖,入境,58222,16223,619,75064
2024-01-30,罗湖,出境,58509,18342,588,77439
2024-01-30,落马洲支线,入境,45844,17239,348,63431
2024-01-30,落马洲支线,出境,47012,16545,287,63844
2024-01-30,香园围,入境,20995,7607,95,28697
2024-01-30,香园围,出境,21364,3583,63,25010
2024-01-30,港珠澳大桥,入境,14778,8959,3445,27182
2024-01-30,港珠澳大桥,出境,14986,13068,3484,31538
2024-01-30,落马洲,入境,9507,3027,333,12867
2024-01-30,落马洲,出境,8248,5308,268,13824
2024-01-30,文锦渡,入境,1429,541,5,1975
2024-01-30,文锦渡,出境,1443,404,6,1853
2024-01-30,沙头角,入境,0,0,0,0
2024-01-30,沙头角,出境,0,0,0,0
2024-01-30,深圳湾,入境,24295,13922,1039,39256
2024-01-30,深圳湾,出境,23666,13835,636,38137
2024-01-30,中国客运码头,入境,648,1189,215,2052
2024-01-30,中国客运码头,出境,707,1410,278,2395
2024-01-30,港口管制,入境,2,0,77,79
2024-01-30,港口管制,出境,1,0,51,52
2024-01-30,启德邮轮码头,入境,0,0,0,0
2024-01-30,启德邮轮码头,出境,0,0,0,0
2024-01-30,港澳客轮码头,入境,3962,1834,2107,7903
2024-01-30,港澳客轮码头,出境,4026,3003,2225,9254
2024-01-31,机场,入境,21509,13281,12477,47267
2024-01-31,机场,出境,20871,14432,16116,51419
2024-01-31,高铁西九龙,入境,11775,21381,1091,34247
2024-01-31,高铁西九龙,出境,10985,20627,776,32388
2024-01-31,红磡,入境,0,0,0,0
2024-01-31,红磡,出境,0,0,0,0
2024-01-31,罗湖,入境,59320,16832,645,76797
2024-01-31,罗湖,出境,58327,19766,501,78594
2024-01-31,落马洲支线,入境,46164,17773,323,64260
2024-01-31,落马洲支线,出境,46211,16827,277,63315
2024-01-31,香园围,入境,20937,7784,101,28822
2024-01-31,香园围,出境,20956,3833,85,24874
2024-01-31,港珠澳大桥,入境,15564,9720,3748,29032
2024-01-31,港珠澳大桥,出境,14208,14422,3520,32150
2024-01-31,落马洲,入境,9812,3201,402,13415
2024-01-31,落马洲,出境,8048,4192,247,12487
2024-01-31,文锦渡,入境,1418,592,18,2028
2024-01-31,文锦渡,出境,1442,450,7,1899
2024-01-31,沙头角,入境,0,0,0,0
2024-01-31,沙头角,出境,0,0,0,0
2024-01-31,深圳湾,入境,25456,14817,1200,41473
2024-01-31,深圳湾,出境,23640,13974,644,38258
2024-01-31,中国客运码头,入境,739,1390,227,2356
2024-01-31,中国客运码头,出境,674,1476,229,2379
2024-01-31,港口管制,入境,3,0,64,67
2024-01-31,港口管制,出境,1,0,70,71
2024-01-31,启德邮轮码头,入境,984,721,57,1762
2024-01-31,启德邮轮码头,出境,1668,106,37,1811
2024-01-31,港澳客轮码头,入境,3493,1778,1799,7070
2024-01-31,港澳客轮码头,出境,3441,3228,1756,8425
2024-02-01,机场,入境,18194,14040,16160,48394
2024-02-01,机场,出境,23631,15274,13946,52851
2024-02-01,高铁西九龙,入境,10399,25876,1041,37316
2024-02-01,高铁西九龙,出境,12550,20643,796,33989
2024-02-01,红磡,入境,0,0,0,0
2024-02-01,红磡,出境,0,0,0,0
2024-02-01,罗湖,入境,58109,18362,674,77145
2024-02-01,罗湖,出境,59736,19874,521,80131
2024-02-01,落马洲支线,入境,45140,18790,399,64329
2024-02-01,落马洲支线,出境,47228,16969,315,64512
2024-02-01,香园围,入境,21565,7336,135,29036
2024-02-01,香园围,出境,22096,3878,142,26116
2024-02-01,港珠澳大桥,入境,14609,11051,3479,29139
2024-02-01,港珠澳大桥,出境,15534,14613,3585,33732
2024-02-01,落马洲,入境,9744,3833,396,13973
2024-02-01,落马洲,出境,8402,4255,293,12950
2024-02-01,文锦渡,入境,1459,660,19,2138
2024-02-01,文锦渡,出境,1477,514,8,1999
2024-02-01,沙头角,入境,0,0,0,0
2024-02-01,沙头角,出境,0,0,0,0
2024-02-01,深圳湾,入境,23996,17261,1264,42521
2024-02-01,深圳湾,出境,24844,14425,727,39996
2024-02-01,中国客运码头,入境,654,1562,200,2416
2024-02-01,中国客运码头,出境,736,1645,233,2614
2024-02-01,港口管制,入境,0,9,23,32
2024-02-01,港口管制,出境,0,13,64,77
2024-02-01,启德邮轮码头,入境,0,0,0,0
2024-02-01,启德邮轮码头,出境,0,0,0,0
2024-02-01,港澳客轮码头,入境,3358,1871,1731,6960
2024-02-01,港澳客轮码头,出境,3725,3275,1762,8762
2024-02-02,机场,入境,18736,13773,15503,48012
2024-02-02,机场,出境,27824,16281,15089,59194
2024-02-02,高铁西九龙,入境,10891,25919,1187,37997
2024-02-02,高铁西九龙,出境,17203,20166,682,38051
2024-02-02,红磡,入境,0,0,0,0
2024-02-02,红磡,出境,0,0,0,0
2024-02-02,罗湖,入境,59374,18548,632,78554
2024-02-02,罗湖,出境,70906,22351,539,93796
2024-02-02,落马洲支线,入境,45992,19653,411,66056
2024-02-02,落马洲支线,出境,56448,18475,281,75204
2024-02-02,香园围,入境,21968,7109,156,29233
2024-02-02,香园围,出境,24177,4019,67,28263
2024-02-02,港珠澳大桥,入境,15771,10325,4148,30244
2024-02-02,港珠澳大桥,出境,20950,14128,3598,38676
2024-02-02,落马洲,入境,10815,4027,521,15363
2024-02-02,落马洲,出境,10535,6083,267,16885
2024-02-02,文锦渡,入境,1432,715,12,2159
2024-02-02,文锦渡,出境,1742,484,7,2233
2024-02-02,沙头角,入境,0,0,0,0
2024-02-02,沙头角,出境,0,0,0,0
2024-02-02,深圳湾,入境,25321,17312,1589,44222
2024-02-02,深圳湾,出境,31489,16111,717,48317
2024-02-02,中国客运码头,入境,764,1371,182,2317
2024-02-02,中国客运码头,出境,1008,1590,207,2805
2024-02-02,港口管制,入境,0,0,46,46
2024-02-02,港口管制,出境,1,0,8,9
2024-02-02,启德邮轮码头,入境,1669,100,44,1813
2024-02-02,启德邮轮码头,出境,1555,185,37,1777
2024-02-02,港澳客轮码头,入境,4350,2031,2261,8642
2024-02-02,港澳客轮码头,出境,5152,3323,2078,10553
2024-02-03,机场,入境,20656,15056,14602,50314
2024-02-03,机场,出境,28387,15829,15692,59908
2024-02-03,高铁西九龙,入境,10872,33538,1228,45638
2024-02-03,高铁西九龙,出境,21214,24597,830,46641
2024-02-03,红磡,入境,0,0,0,0
2024-02-03,红磡,出境,0,0,0,0
2024-02-03,罗湖,入境,68092,24340,685,93117
2024-02-03,罗湖,出境,87813,29652,571,118036
2024-02-03,落马洲支线,入境,53486,28388,510,82384
2024-02-03,落马洲支线,出境,72739,27048,349,100136
2024-02-03,香园围,入境,25382,9466,157,35005
2024-02-03,香园围,出境,30764,5277,77,36118
2024-02-03,港珠澳大桥,入境,19477,10935,6704,37116
2024-02-03,港珠澳大桥,出境,28827,14453,5303,48583
2024-02-03,落马洲,入境,14936,4742,644,20322
2024-02-03,落马洲,出境,14932,6930,288,22150
2024-02-03,文锦渡,入境,1113,871,24,2008
2024-02-03,文锦渡,出境,1578,642,13,2233
2024-02-03,沙头角,入境,0,0,0,0
2024-02-03,沙头角,出境,0,0,0,0
2024-02-03,深圳湾,入境,29137,22730,1786,53653
2024-02-03,深圳湾,出境,36954,20350,818,58122
2024-02-03,中国客运码头,入境,647,1933,264,2844
2024-02-03,中国客运码头,出境,1095,1919,292,3306
2024-02-03,港口管制,入境,0,0,76,76
2024-02-03,港口管制,出境,0,0,34,34
2024-02-03,启德邮轮码头,入境,32,309,1855,2196
2024-02-03,启德邮轮码头,出境,327,321,1606,2254
2024-02-03,港澳客轮码头,入境,4467,2293,2687,9447
2024-02-03,港澳客轮码头,出境,6273,3171,2464,11908
2024-02-04,机场,入境,25238,15129,11621,51988
2024-02-04,机场,出境,23120,15615,20260,58995
2024-02-04,高铁西九龙,入境,17037,29430,1113,47580
2024-02-04,高铁西九龙,出境,16281,23477,868,40626
2024-02-04,红磡,入境,0,0,0,0
2024-02-04,红磡,出境,0,0,0,0
2024-02-04,罗湖,入境,80763,20401,536,101700
2024-02-04,罗湖,出境,64805,22858,504,88167
2024-02-04,落马洲支线,入境,63525,18950,424,82899
2024-02-04,落马洲支线,出境,51990,16795,307,69092
2024-02-04,香园围,入境,28978,8280,109,37367
2024-02-04,香园围,出境,23859,4101,74,28034
2024-02-04,港珠澳大桥,入境,30809,11025,5763,47597
2024-02-04,港珠澳大桥,出境,20415,14413,6211,41039
2024-02-04,落马洲,入境,19747,4373,466,24586
2024-02-04,落马洲,出境,10948,7359,243,18550
2024-02-04,文锦渡,入境,1348,659,9,2016
2024-02-04,文锦渡,出境,1040,486,7,1533
2024-02-04,沙头角,入境,0,0,0,0
2024-02-04,沙头角,出境,0,0,0,0
2024-02-04,深圳湾,入境,37587,18481,1412,57480
2024-02-04,深圳湾,出境,28404,16182,748,45334
2024-02-04,中国客运码头,入境,1106,2194,223,3523
2024-02-04,中国客运码头,出境,685,1794,271,2750
2024-02-04,港口管制,入境,3,4,35,42
2024-02-04,港口管制,出境,0,4,26,30
2024-02-04,启德邮轮码头,入境,1554,185,15,1754
2024-02-04,启德邮轮码头,出境,767,878,68,1713
2024-02-04,港澳客轮码头,入境,6549,2141,2200,10890
2024-02-04,港澳客轮码头,出境,3899,3720,2562,10181
2024-02-05,机场,入境,22011,14846,9840,46697
2024-02-05,机场,出境,21708,16750,16177,54635
2024-02-05,高铁西九龙,入境,10028,30017,935,40980
2024-02-05,高铁西九龙,出境,15128,23788,847,39763
2024-02-05,红磡,入境,0,0,0,0
2024-02-05,红磡,出境,0,0,0,0
2024-02-05,罗湖,入境,56325,22449,648,79422
2024-02-05,罗湖,出境,60150,25651,574,86375
2024-02-05,落马洲支线,入境,43818,21312,370,65500
2024-02-05,落马洲支线,出境,45449,18904,301,64654
2024-02-05,香园围,入境,20825,8641,110,29576
2024-02-05,香园围,出境,21209,4234,86,25529
2024-02-05,港珠澳大桥,入境,16099,11958,3859,31916
2024-02-05,港珠澳大桥,出境,16932,16981,3594,37507
2024-02-05,落马洲,入境,10605,4830,419,15854
2024-02-05,落马洲,出境,8172,6911,288,15371
2024-02-05,文锦渡,入境,1376,730,13,2119
2024-02-05,文锦渡,出境,1417,552,9,1978
2024-02-05,沙头角,入境,0,0,0,0
2024-02-05,沙头角,出境,0,0,0,0
2024-02-05,深圳湾,入境,23749,21058,1267,46074
2024-02-05,深圳湾,出境,25817,18653,801,45271
2024-02-05,中国客运码头,入境,749,2201,190,3140
2024-02-05,中国客运码头,出境,806,2274,217,3297
2024-02-05,港口管制,入境,6,0,67,73
2024-02-05,港口管制,出境,3,5,59,67
2024-02-05,启德邮轮码头,入境,10,187,13,210
2024-02-05,启德邮轮码头,出境,15,187,11,213
2024-02-05,港澳客轮码头,入境,4226,2284,1850,8360
2024-02-05,港澳客轮码头,出境,4092,4259,1802,10153
2024-02-06,机场,入境,19840,15618,9118,44576
2024-02-06,机场,出境,33375,15615,13812,62802
2024-02-06,高铁西九龙,入境,8074,28084,826,36984
2024-02-06,高铁西九龙,出境,23232,24409,702,48343
2024-02-06,红磡,入境,0,0,0,0
2024-02-06,红磡,出境,0,0,0,0
2024-02-06,罗湖,入境,49458,20148,514,70120
2024-02-06,罗湖,出境,68260,26630,504,95394
2024-02-06,落马洲支线,入境,39173,19464,392,59029
2024-02-06,落马洲支线,出境,49504,19275,304,69083
2024-02-06,香园围,入境,20087,8102,127,28316
2024-02-06,香园围,出境,22983,4534,69,27586
2024-02-06,港珠澳大桥,入境,14587,11691,3530,29808
2024-02-06,港珠澳大桥,出境,21135,18636,3620,43391
2024-02-06,落马洲,入境,9316,4371,520,14207
2024-02-06,落马洲,出境,9349,6904,291,16544
2024-02-06,文锦渡,入境,1160,767,9,1936
2024-02-06,文锦渡,出境,1424,539,9,1972
2024-02-06,沙头角,入境,0,0,0,0
2024-02-06,沙头角,出境,0,0,0,0
2024-02-06,深圳湾,入境,21536,19916,1281,42733
2024-02-06,深圳湾,出境,32426,20415,746,53587
2024-02-06,中国客运码头,入境,618,2137,172,2927
2024-02-06,中国客运码头,出境,1063,2480,190,3733
2024-02-06,港口管制,入境,0,0,15,15
2024-02-06,港口管制,出境,0,0,16,16
2024-02-06,启德邮轮码头,入境,0,0,0,0
2024-02-06,启德邮轮码头,出境,0,0,0,0
2024-02-06,港澳客轮码头,入境,3899,2225,1696,7820
2024-02-06,港澳客轮码头,出境,3985,4583,1792,10360
2024-02-07,机场,入境,21152,17138,12223,50513
2024-02-07,机场,出境,46023,11561,10981,68565
2024-02-07,高铁西九龙,入境,7667,24259,785,32711
2024-02-07,高铁西九龙,出境,34660,23008,841,58509
2024-02-07,红磡,入境,0,0,0,0
2024-02-07,红磡,出境,0,0,0,0
2024-02-07,罗湖,入境,42973,17438,436,60847
2024-02-07,罗湖,出境,78739,25462,602,104803
2024-02-07,落马洲支线,入境,34271,15452,337,50060
2024-02-07,落马洲支线,出境,53682,17370,345,71397
2024-02-07,香园围,入境,17759,7643,100,25502
2024-02-07,香园围,出境,22244,4310,110,26664
2024-02-07,港珠澳大桥,入境,13907,10179,3898,27984
2024-02-07,港珠澳大桥,出境,28882,17403,4419,50704
2024-02-07,落马洲,入境,8519,3326,467,12312
2024-02-07,落马洲,出境,10395,6210,315,16920
2024-02-07,文锦渡,入境,961,519,25,1505
2024-02-07,文锦渡,出境,1313,437,15,1765
2024-02-07,沙头角,入境,0,0,0,0
2024-02-07,沙头角,出境,0,0,0,0
2024-02-07,深圳湾,入境,18832,15730,1212,35774
2024-02-07,深圳湾,出境,39068,18832,894,58794
2024-02-07,中国客运码头,入境,534,1759,157,2450
2024-02-07,中国客运码头,出境,1828,2557,192,4577
2024-02-07,港口管制,入境,29,0,38,67
2024-02-07,港口管制,出境,0,0,37,37
2024-02-07,启德邮轮码头,入境,0,0,0,0
2024-02-07,启德邮轮码头,出境,0,0,0,0
2024-02-07,港澳客轮码头,入境,3734,1989,1517,7240
2024-02-07,港澳客轮码头,出境,4172,4489,1727,10388
2024-02-08,机场,入境,22902,17444,16448,56794
2024-02-08,机场,出境,50573,9516,9205,69294
2024-02-08,高铁西九龙,入境,6327,20506,657,27490
2024-02-08,高铁西九龙,出境,41350,20015,770,62135
2024-02-08,红磡,入境,0,0,0,0
2024-02-08,红磡,出境,0,0,0,0
2024-02-08,罗湖,入境,35246,13464,378,49088
2024-02-08,罗湖,出境,76562,18349,598,95509
2024-02-08,落马洲支线,入境,28012,12272,309,40593
2024-02-08,落马洲支线,出境,51452,12681,329,64462
2024-02-08,香园围,入境,15801,6886,96,22783
2024-02-08,香园围,出境,22026,3313,105,25444
2024-02-08,港珠澳大桥,入境,14213,8568,3776,26557
2024-02-08,港珠澳大桥,出境,30484,14720,4299,49503
2024-02-08,落马洲,入境,7616,2563,354,10533
2024-02-08,落马洲,出境,10795,4494,355,15644
2024-02-08,文锦渡,入境,742,366,11,1119
2024-02-08,文锦渡,出境,1174,448,7,1629
2024-02-08,沙头角,入境,0,0,0,0
2024-02-08,沙头角,出境,0,0,0,0
2024-02-08,深圳湾,入境,15758,12073,850,28681
2024-02-08,深圳湾,出境,42577,15138,890,58605
2024-02-08,中国客运码头,入境,582,1256,174,2012
2024-02-08,中国客运码头,出境,2459,2248,223,4930
2024-02-08,港口管制,入境,4,0,102,106
2024-02-08,港口管制,出境,14,0,81,95
2024-02-08,启德邮轮码头,入境,16,104,53,173
2024-02-08,启德邮轮码头,出境,1700,96,104,1900
2024-02-08,港澳客轮码头,入境,3674,1771,1646,7091
2024-02-08,港澳客轮码头,出境,4588,3657,1856,10101
2024-02-09,机场,入境,18425,13191,17586,49202
2024-02-09,机场,出境,60485,5942,6781,73208
2024-02-09,高铁西九龙,入境,4155,13522,554,18231
2024-02-09,高铁西九龙,出境,44544,10760,632,55936
2024-02-09,红磡,入境,0,0,0,0
2024-02-09,红磡,出境,0,0,0,0
2024-02-09,罗湖,入境,22329,9810,350,32489
2024-02-09,罗湖,出境,67341,8047,395,75783
2024-02-09,落马洲支线,入境,19123,7760,172,27055
2024-02-09,落马洲支线,出境,48089,5397,209,53695
2024-02-09,香园围,入境,9060,5891,36,14987
2024-02-09,香园围,出境,16843,1488,49,18380
2024-02-09,港珠澳大桥,入境,13014,6166,3940,23120
2024-02-09,港珠澳大桥,出境,34469,9691,3449,47609
2024-02-09,落马洲,入境,5591,1783,151,7525
2024-02-09,落马洲,出境,10227,2454,210,12891
2024-02-09,文锦渡,入境,602,193,6,801
2024-02-09,文锦渡,出境,1046,131,10,1187
2024-02-09,沙头角,入境,0,0,0,0
2024-02-09,沙头角,出境,0,0,0,0
2024-02-09,深圳湾,入境,10199,7314,517,18030
2024-02-09,深圳湾,出境,41520,6020,503,48043
2024-02-09,中国客运码头,入境,407,974,143,1524
2024-02-09,中国客运码头,出境,3841,1181,200,5222
2024-02-09,港口管制,入境,12,0,36,48
2024-02-09,港口管制,出境,42,0,39,81
2024-02-09,启德邮轮码头,入境,771,874,66,1711
2024-02-09,启德邮轮码头,出境,1322,206,25,1553
2024-02-09,港澳客轮码头,入境,3388,1558,1712,6658
2024-02-09,港澳客轮码头,出境,6438,2331,1699,10468
2024-02-10,机场,入境,15659,15127,17116,47902
2024-02-10,机场,出境,49687,7223,7481,64391
2024-02-10,高铁西九龙,入境,4853,27428,526,32807
2024-02-10,高铁西九龙,出境,38840,17181,674,56695
2024-02-10,红磡,入境,0,0,0,0
2024-02-10,红磡,出境,0,0,0,0
2024-02-10,罗湖,入境,27884,13102,297,41283
2024-02-10,罗湖,出境,66800,15340,518,82658
2024-02-10,落马洲支线,入境,23974,12018,182,36174
2024-02-10,落马洲支线,出境,51704,10019,252,61975
2024-02-10,香园围,入境,10406,7811,48,18265
2024-02-10,香园围,出境,17505,2251,76,19832
2024-02-10,港珠澳大桥,入境,20887,9354,5065,35306
2024-02-10,港珠澳大桥,出境,43188,14632,4328,62148
2024-02-10,落马洲,入境,5313,2142,93,7548
2024-02-10,落马洲,出境,8067,1866,192,10125
2024-02-10,文锦渡,入境,489,309,2,800
2024-02-10,文锦渡,出境,743,167,4,914
2024-02-10,沙头角,入境,0,0,0,0
2024-02-10,沙头角,出境,0,0,0,0
2024-02-10,深圳湾,入境,15792,10445,433,26670
2024-02-10,深圳湾,出境,45067,7467,660,53194
2024-02-10,中国客运码头,入境,367,1684,209,2260
2024-02-10,中国客运码头,出境,3018,1421,242,4681
2024-02-10,港口管制,入境,1,0,21,22
2024-02-10,港口管制,出境,1,0,18,19
2024-02-10,启德邮轮码头,入境,17,467,13,497
2024-02-10,启德邮轮码头,出境,15,466,14,495
2024-02-10,港澳客轮码头,入境,4514,2267,2039,8820
2024-02-10,港澳客轮码头,出境,7706,3827,2133,13666
2024-02-11,机场,入境,17292,17937,13100,48329
2024-02-11,机场,出境,39349,10866,11911,62126
2024-02-11,高铁西九龙,入境,13087,44991,670,58748
2024-02-11,高铁西九龙,出境,31249,24904,747,56900
2024-02-11,红磡,入境,0,0,0,0
2024-02-11,红磡,出境,0,0,0,0
2024-02-11,罗湖,入境,51836,29213,484,81533
2024-02-11,罗湖,出境,75153,37083,703,112939
2024-02-11,落马洲支线,入境,47213,27425,304,74942
2024-02-11,落马洲支线,出境,67138,23767,409,91314
2024-02-11,香园围,入境,18194,13454,81,31729
2024-02-11,香园围,出境,25684,3823,133,29640
2024-02-11,港珠澳大桥,入境,35675,16761,6082,58518
2024-02-11,港珠澳大桥,出境,53832,22880,5566,82278
2024-02-11,落马洲,入境,10479,4859,142,15480
2024-02-11,落马洲,出境,11001,5007,234,16242
2024-02-11,文锦渡,入境,661,662,8,1331
2024-02-11,文锦渡,出境,806,305,4,1115
2024-02-11,沙头角,入境,0,0,0,0
2024-02-11,沙头角,出境,0,0,0,0
2024-02-11,深圳湾,入境,33069,21941,640,55650
2024-02-11,深圳湾,出境,48869,16140,751,65760
2024-02-11,中国客运码头,入境,933,2751,257,3941
2024-02-11,中国客运码头,出境,2730,1838,237,4805
2024-02-11,港口管制,入境,0,0,8,8
2024-02-11,港口管制,出境,2,0,25,27
2024-02-11,启德邮轮码头,入境,1323,206,20,1549
2024-02-11,启德邮轮码头,出境,1334,782,103,2219
2024-02-11,港澳客轮码头,入境,7705,3474,2265,13444
2024-02-11,港澳客轮码头,出境,8511,5108,2593,16212
2024-02-12,机场,入境,26994,17682,10993,55669
2024-02-12,机场,出境,34397,12898,15258,62553
2024-02-12,高铁西九龙,入境,23777,41548,750,66075
2024-02-12,高铁西九龙,出境,25524,29255,817,55596
2024-02-12,红磡,入境,0,0,0,0
2024-02-12,红磡,出境,0,0,0,0
2024-02-12,罗湖,入境,86603,29947,637,117187
2024-02-12,罗湖,出境,70081,36165,738,106984
2024-02-12,落马洲支线,入境,74929,27284,407,102620
2024-02-12,落马洲支线,出境,78398,24751,404,103553
2024-02-12,香园围,入境,26860,15044,115,42019
2024-02-12,香园围,出境,30603,5479,177,36259
2024-02-12,港珠澳大桥,入境,49597,19733,6081,75411
2024-02-12,港珠澳大桥,出境,59060,29344,6228,94632
2024-02-12,落马洲,入境,15738,4793,183,20714
2024-02-12,落马洲,出境,11539,5315,263,17117
2024-02-12,文锦渡,入境,717,717,5,1439
2024-02-12,文锦渡,出境,869,410,9,1288
2024-02-12,沙头角,入境,0,0,0,0
2024-02-12,沙头角,出境,0,0,0,0
2024-02-12,深圳湾,入境,52234,22115,699,75048
2024-02-12,深圳湾,出境,45940,19766,863,66569
2024-02-12,中国客运码头,入境,2526,3047,169,5742
2024-02-12,中国客运码头,出境,2270,2553,224,5047
2024-02-12,港口管制,入境,17,0,10,27
2024-02-12,港口管制,出境,0,0,15,15
2024-02-12,启德邮轮码头,入境,0,0,0,0
2024-02-12,启德邮轮码头,出境,0,0,0,0
2024-02-12,港澳客轮码头,入境,9006,3752,2078,14836
2024-02-12,港澳客轮码头,出境,8824,6427,2381,17632
2024-02-13,机场,入境,45037,12699,8336,66072
2024-02-13,机场,出境,31605,14318,15111,61034
2024-02-13,高铁西九龙,入境,35494,36338,818,72650
2024-02-13,高铁西九龙,出境,15717,31296,763,47776
2024-02-13,红磡,入境,0,0,0,0
2024-02-13,红磡,出境,0,0,0,0
2024-02-13,罗湖,入境,95274,31437,753,127464
2024-02-13,罗湖,出境,49926,34306,571,84803
2024-02-13,落马洲支线,入境,72566,28512,397,101475
2024-02-13,落马洲支线,出境,48806,23708,347,72861
2024-02-13,香园围,入境,28072,13394,159,41625
2024-02-13,香园围,出境,21004,5548,224,26776
2024-02-13,港珠澳大桥,入境,66976,22246,6476,95698
2024-02-13,港珠澳大桥,出境,38761,30689,6271,75721
2024-02-13,落马洲,入境,20452,5036,190,25678
2024-02-13,落马洲,出境,9449,5662,243,15354
2024-02-13,文锦渡,入境,1178,693,8,1879
2024-02-13,文锦渡,出境,727,446,3,1176
2024-02-13,沙头角,入境,0,0,0,0
2024-02-13,沙头角,出境,0,0,0,0
2024-02-13,深圳湾,入境,63283,23008,870,87161
2024-02-13,深圳湾,出境,30083,19674,996,50753
2024-02-13,中国客运码头,入境,3803,3168,190,7161
2024-02-13,中国客运码头,出境,1198,2680,188,4066
2024-02-13,港口管制,入境,25,0,29,54
2024-02-13,港口管制,出境,0,0,14,14
2024-02-13,启德邮轮码头,入境,8,200,4,212
2024-02-13,启德邮轮码头,出境,6,200,4,210
2024-02-13,港澳客轮码头,入境,10566,4534,2381,17481
2024-02-13,港澳客轮码头,出境,6905,7650,2462,17017
2024-02-14,机场,入境,42578,14947,10141,67666
2024-02-14,机场,出境,26422,15187,14298,55907
2024-02-14,高铁西九龙,入境,30394,32449,850,63693
2024-02-14,高铁西九龙,出境,12466,32014,746,45226
2024-02-14,红磡,入境,0,0,0,0
2024-02-14,红磡,出境,0,0,0,0
2024-02-14,罗湖,入境,86927,31443,667,119037
2024-02-14,罗湖,出境,48442,36490,612,85544
2024-02-14,落马洲支线,入境,66488,28605,400,95493
2024-02-14,落马洲支线,出境,51158,25482,392,77032
2024-02-14,香园围,入境,27009,11615,150,38774
2024-02-14,香园围,出境,21931,5209,258,27398
2024-02-14,港珠澳大桥,入境,50322,22771,4993,78086
2024-02-14,港珠澳大桥,出境,32615,30265,5597,68477
2024-02-14,落马洲,入境,17514,4887,289,22690
2024-02-14,落马洲,出境,9029,6528,353,15910
2024-02-14,文锦渡,入境,1050,747,8,1805
2024-02-14,文锦渡,出境,675,437,9,1121
2024-02-14,沙头角,入境,0,0,0,0
2024-02-14,沙头角,出境,0,0,0,0
2024-02-14,深圳湾,入境,52688,22733,917,76338
2024-02-14,深圳湾,出境,27646,21676,1234,50556
2024-02-14,中国客运码头,入境,2715,3215,166,6096
2024-02-14,中国客运码头,出境,1032,2734,239,4005
2024-02-14,港口管制,入境,0,0,24,24
2024-02-14,港口管制,出境,1,0,16,17
2024-02-14,启德邮轮码头,入境,0,0,0,0
2024-02-14,启德邮轮码头,出境,0,0,0,0
2024-02-14,港澳客轮码头,入境,7543,4446,1990,13979
2024-02-14,港澳客轮码头,出境,6386,8016,2056,16458
2024-02-15,机场,入境,40851,17636,12223,70710
2024-02-15,机场,出境,28570,15004,12165,55739
2024-02-15,高铁西九龙,入境,25989,31823,901,58713
2024-02-15,高铁西九龙,出境,11284,33945,785,46014
2024-02-15,红磡,入境,0,0,0,0
2024-02-15,红磡,出境,0,0,0,0
2024-02-15,罗湖,入境,74232,28854,741,103827
2024-02-15,罗湖,出境,43349,33607,668,77624
2024-02-15,落马洲支线,入境,53669,26042,434,80145
2024-02-15,落马洲支线,出境,42240,25068,432,67740
2024-02-15,香园围,入境,23513,10384,124,34021
2024-02-15,香园围,出境,19843,5379,171,25393
2024-02-15,港珠澳大桥,入境,42489,20345,4663,67497
2024-02-15,港珠澳大桥,出境,27938,26286,4985,59209
2024-02-15,落马洲,入境,15759,4649,294,20702
2024-02-15,落马洲,出境,7541,7981,506,16028
2024-02-15,文锦渡,入境,985,780,16,1781
2024-02-15,文锦渡,出境,734,487,8,1229
2024-02-15,沙头角,入境,0,0,0,0
2024-02-15,沙头角,出境,0,0,0,0
2024-02-15,深圳湾,入境,42730,21003,943,64676
2024-02-15,深圳湾,出境,23364,22898,1566,47828
2024-02-15,中国客运码头,入境,2020,3177,186,5383
2024-02-15,中国客运码头,出境,1053,2919,170,4142
2024-02-15,港口管制,入境,0,0,36,36
2024-02-15,港口管制,出境,0,0,55,55
2024-02-15,启德邮轮码头,入境,0,0,280,280
2024-02-15,启德邮轮码头,出境,0,0,0,0
2024-02-15,港澳客轮码头,入境,6463,4062,1953,12478
2024-02-15,港澳客轮码头,出境,5732,7306,1997,15035
2024-02-16,机场,入境,45486,17689,12528,75703
2024-02-16,机场,出境,25739,14913,11039,51691
2024-02-16,高铁西九龙,入境,25293,29981,883,56157
2024-02-16,高铁西九龙,出境,12445,35061,864,48370
2024-02-16,红磡,入境,0,0,0,0
2024-02-16,红磡,出境,0,0,0,0
2024-02-16,罗湖,入境,70037,23244,647,93928
2024-02-16,罗湖,出境,48686,30459,744,79889
2024-02-16,落马洲支线,入境,52785,22147,436,75368
2024-02-16,落马洲支线,出境,47462,23607,525,71594
2024-02-16,香园围,入境,24139,7850,209,32198
2024-02-16,香园围,出境,21338,4825,140,26303
2024-02-16,港珠澳大桥,入境,40163,16310,5000,61473
2024-02-16,港珠澳大桥,出境,33880,22194,5057,61131
2024-02-16,落马洲,入境,13732,4061,204,17997
2024-02-16,落马洲,出境,8634,8940,553,18127
2024-02-16,文锦渡,入境,883,645,9,1537
2024-02-16,文锦渡,出境,802,542,16,1360
2024-02-16,沙头角,入境,0,0,0,0
2024-02-16,沙头角,出境,0,0,0,0
2024-02-16,深圳湾,入境,39870,18232,833,58935
2024-02-16,深圳湾,出境,25732,24549,1863,52144
2024-02-16,中国客运码头,入境,1898,2591,232,4721
2024-02-16,中国客运码头,出境,1207,2901,211,4319
2024-02-16,港口管制,入境,2,0,58,60
2024-02-16,港口管制,出境,3,1,56,60
2024-02-16,启德邮轮码头,入境,1333,779,110,2222
2024-02-16,启德邮轮码头,出境,1776,110,358,2244
2024-02-16,港澳客轮码头,入境,6301,3512,2199,12012
2024-02-16,港澳客轮码头,出境,7532,5852,2307,15691
2024-02-17,机场,入境,54467,13446,10800,78713
2024-02-17,机场,出境,25552,13418,12065,51035
2024-02-17,高铁西九龙,入境,29221,21926,790,51937
2024-02-17,高铁西九龙,出境,13914,34318,1087,49319
2024-02-17,红磡,入境,0,0,0,0
2024-02-17,红磡,出境,0,0,0,0
2024-02-17,罗湖,入境,79526,16618,418,96562
2024-02-17,罗湖,出境,60838,22689,590,84117
2024-02-17,落马洲支线,入境,58627,15259,312,74198
2024-02-17,落马洲支线,出境,57364,17559,380,75303
2024-02-17,香园围,入境,27789,6251,122,34162
2024-02-17,香园围,出境,26376,3894,128,30398
2024-02-17,港珠澳大桥,入境,46390,13305,6269,65964
2024-02-17,港珠澳大桥,出境,36562,17019,6078,59659
2024-02-17,落马洲,入境,16414,2723,256,19393
2024-02-17,落马洲,出境,11195,6949,672,18816
2024-02-17,文锦渡,入境,927,448,8,1383
2024-02-17,文锦渡,出境,951,378,5,1334
2024-02-17,沙头角,入境,0,0,0,0
2024-02-17,沙头角,出境,0,0,0,0
2024-02-17,深圳湾,入境,47728,13136,752,61616
2024-02-17,深圳湾,出境,33096,19166,1756,54018
2024-02-17,中国客运码头,入境,2127,1759,200,4086
2024-02-17,中国客运码头,出境,1268,2585,197,4050
2024-02-17,港口管制,入境,0,0,60,60
2024-02-17,港口管制,出境,0,0,25,25
2024-02-17,启德邮轮码头,入境,1705,691,62,2458
2024-02-17,启德邮轮码头,出境,934,629,72,1635
2024-02-17,港澳客轮码头,入境,6935,2529,2212,11676
2024-02-17,港澳客轮码头,出境,8452,3968,2250,14670
2024-02-18,机场,入境,61938,9532,10526,81996
2024-02-18,机场,出境,25125,12544,13949,51618
2024-02-18,高铁西九龙,入境,39842,16454,680,56976
2024-02-18,高铁西九龙,出境,9283,21815,906,32004
2024-02-18,红磡,入境,0,0,0,0
2024-02-18,红磡,出境,0,0,0,0
2024-02-18,罗湖,入境,94717,14191,458,109366
2024-02-18,罗湖,出境,46060,16022,469,62551
2024-02-18,落马洲支线,入境,71013,12482,271,83766
2024-02-18,落马洲支线,出境,41515,12291,324,54130
2024-02-18,香园围,入境,30169,6287,116,36572
2024-02-18,香园围,出境,20440,3865,129,24434
2024-02-18,港珠澳大桥,入境,50030,12175,4479,66684
2024-02-18,港珠澳大桥,出境,20646,12870,5638,39154
2024-02-18,落马洲,入境,21348,2420,176,23944
2024-02-18,落马洲,出境,9071,4251,659,13981
2024-02-18,文锦渡,入境,1363,428,7,1798
2024-02-18,文锦渡,出境,748,302,7,1057
2024-02-18,沙头角,入境,0,0,0,0
2024-02-18,沙头角,出境,0,0,0,0
2024-02-18,深圳湾,入境,53754,10702,700,65156
2024-02-18,深圳湾,出境,23456,12190,1624,37270
2024-02-18,中国客运码头,入境,2758,1339,112,4209
2024-02-18,中国客运码头,出境,611,1807,156,2574
2024-02-18,港口管制,入境,0,0,78,78
2024-02-18,港口管制,出境,2,0,61,63
2024-02-18,启德邮轮码头,入境,1776,110,42,1928
2024-02-18,启德邮轮码头,出境,1028,361,111,1500
2024-02-18,港澳客轮码头,入境,9241,1838,1706,12785
2024-02-18,港澳客轮码头,出境,4766,3329,2061,10156
2024-02-19,机场,入境,43974,15547,13852,73373
2024-02-19,机场,出境,21866,10541,9612,42019
2024-02-19,高铁西九龙,入境,24470,17463,714,42647
2024-02-19,高铁西九龙,出境,9294,17237,811,27342
2024-02-19,红磡,入境,0,0,0,0
2024-02-19,红磡,出境,0,0,0,0
2024-02-19,罗湖,入境,59627,12274,453,72354
2024-02-19,罗湖,出境,47856,13579,540,61975
2024-02-19,落马洲支线,入境,47857,11262,209,59328
2024-02-19,落马洲支线,出境,41684,11308,342,53334
2024-02-19,香园围,入境,21095,4908,83,26086
2024-02-19,香园围,出境,19766,3046,125,22937
2024-02-19,港珠澳大桥,入境,21021,8625,3163,32809
2024-02-19,港珠澳大桥,出境,16562,11492,3516,31570
2024-02-19,落马洲,入境,11829,2593,143,14565
2024-02-19,落马洲,出境,7326,3925,535,11786
2024-02-19,文锦渡,入境,1321,300,11,1632
2024-02-19,文锦渡,出境,1171,253,15,1439
2024-02-19,沙头角,入境,0,0,0,0
2024-02-19,沙头角,出境,0,0,0,0
2024-02-19,深圳湾,入境,29178,10273,585,40036
2024-02-19,深圳湾,出境,21590,11970,1332,34892
2024-02-19,中国客运码头,入境,967,1059,173,2199
2024-02-19,中国客运码头,出境,626,1379,177,2182
2024-02-19,港口管制,入境,1,0,10,11
2024-02-19,港口管制,出境,22,0,18,40
2024-02-19,启德邮轮码头,入境,0,0,0,0
2024-02-19,启德邮轮码头,出境,0,0,0,0
2024-02-19,港澳客轮码头,入境,5807,1620,1550,8977
2024-02-19,港澳客轮码头,出境,4703,2288,1545,8536
2024-02-20,机场,入境,32674,16084,15641,64399
2024-02-20,机场,出境,19215,9609,9780,38604
2024-02-20,高铁西九龙,入境,15962,15822,676,32460
2024-02-20,高铁西九龙,出境,9231,15492,851,25574
2024-02-20,红磡,入境,0,0,0,0
2024-02-20,红磡,出境,0,0,0,0
2024-02-20,罗湖,入境,53403,10798,356,64557
2024-02-20,罗湖,出境,49177,12326,578,62081
2024-02-20,落马洲支线,入境,43789,11083,203,55075
2024-02-20,落马洲支线,出境,42445,11138,338,53921
2024-02-20,香园围,入境,20103,4754,70,24927
2024-02-20,香园围,出境,20251,2932,157,23340
2024-02-20,港珠澳大桥,入境,17125,8304,3001,28430
2024-02-20,港珠澳大桥,出境,15767,11430,3271,30468
2024-02-20,落马洲,入境,8671,1947,159,10777
2024-02-20,落马洲,出境,7070,3933,493,11496
2024-02-20,文锦渡,入境,1361,313,16,1690
2024-02-20,文锦渡,出境,1303,285,21,1609
2024-02-20,沙头角,入境,0,0,0,0
2024-02-20,沙头角,出境,0,0,0,0
2024-02-20,深圳湾,入境,23512,8669,645,32826
2024-02-20,深圳湾,出境,20371,10685,1201,32257
2024-02-20,中国客运码头,入境,660,840,211,1711
2024-02-20,中国客运码头,出境,632,1159,177,1968
2024-02-20,港口管制,入境,0,1,147,148
2024-02-20,港口管制,出境,0,0,16,16
2024-02-20,启德邮轮码头,入境,194,46,2567,2807
2024-02-20,启德邮轮码头,出境,127,9,2733,2869
2024-02-20,港澳客轮码头,入境,4891,1337,1520,7748
2024-02-20,港澳客轮码头,出境,4311,2129,1472,7912
2024-02-21,机场,入境,26423,15072,18144,59639
2024-02-21,机场,出境,20261,8521,9541,38323
2024-02-21,高铁西九龙,入境,12517,14369,673,27559
2024-02-21,高铁西九龙,出境,9930,15169,902,26001
2024-02-21,红磡,入境,0,0,0,0
2024-02-21,红磡,出境,0,0,0,0
2024-02-21,罗湖,入境,52031,11187,363,63581
2024-02-21,罗湖,出境,49964,13095,522,63581
2024-02-21,落马洲支线,入境,43386,11864,238,55488
2024-02-21,落马洲支线,出境,43278,11954,292,55524
2024-02-21,香园围,入境,20393,4419,102,24914
2024-02-21,香园围,出境,20567,3537,133,24237
2024-02-21,港珠澳大桥,入境,15892,8878,2967,27737
2024-02-21,港珠澳大桥,出境,15348,10769,3330,29447
2024-02-21,落马洲,入境,8794,1962,140,10896
2024-02-21,落马洲,出境,7201,3535,401,11137
2024-02-21,文锦渡,入境,1390,397,7,1794
2024-02-21,文锦渡,出境,1421,304,18,1743
2024-02-21,沙头角,入境,0,0,0,0
2024-02-21,沙头角,出境,0,0,0,0
2024-02-21,深圳湾,入境,22247,8332,595,31174
2024-02-21,深圳湾,出境,20901,10351,1173,32425
2024-02-21,中国客运码头,入境,645,949,190,1784
2024-02-21,中国客运码头,出境,561,985,177,1723
2024-02-21,港口管制,入境,1,0,45,46
2024-02-21,港口管制,出境,1,26,44,71
2024-02-21,启德邮轮码头,入境,8,0,717,725
2024-02-21,启德邮轮码头,出境,26,0,684,710
2024-02-21,港澳客轮码头,入境,4505,1422,1875,7802
2024-02-21,港澳客轮码头,出境,4153,2412,1974,8539
2024-02-22,机场,入境,21279,12573,22463,56315
2024-02-22,机场,出境,24921,8392,11207,44520
2024-02-22,高铁西九龙,入境,11149,13638,747,25534
2024-02-22,高铁西九龙,出境,10846,16014,902,27762
2024-02-22,红磡,入境,0,0,0,0
2024-02-22,红磡,出境,0,0,0,0
2024-02-22,罗湖,入境,51909,10704,512,63125
2024-02-22,罗湖,出境,51239,12927,654,64820
2024-02-22,落马洲支线,入境,43245,11361,295,54901
2024-02-22,落马洲支线,出境,44642,11632,332,56606
2024-02-22,香园围,入境,20626,4311,143,25080
2024-02-22,香园围,出境,21534,2613,139,24286
2024-02-22,港珠澳大桥,入境,15686,7056,3439,26181
2024-02-22,港珠澳大桥,出境,16487,9196,3964,29647
2024-02-22,落马洲,入境,8913,1924,207,11044
2024-02-22,落马洲,出境,7603,3167,384,11154
2024-02-22,文锦渡,入境,1385,337,12,1734
2024-02-22,文锦渡,出境,1413,299,8,1720
2024-02-22,沙头角,入境,0,0,0,0
2024-02-22,沙头角,出境,0,0,0,0
2024-02-22,深圳湾,入境,22234,8547,667,31448
2024-02-22,深圳湾,出境,21967,10603,921,33491
2024-02-22,中国客运码头,入境,608,829,188,1625
2024-02-22,中国客运码头,出境,617,869,280,1766
2024-02-22,港口管制,入境,0,0,88,88
2024-02-22,港口管制,出境,2,0,36,38
2024-02-22,启德邮轮码头,入境,913,56,35,1004
2024-02-22,启德邮轮码头,出境,756,36,61,853
2024-02-22,港澳客轮码头,入境,4529,1464,2408,8401
2024-02-22,港澳客轮码头,出境,4615,2130,2561,9306
2024-02-23,机场,入境,21610,10426,25161,57197
2024-02-23,机场,出境,28393,10122,14311,52826
2024-02-23,高铁西九龙,入境,11878,13857,831,26566
2024-02-23,高铁西九龙,出境,18540,16055,1001,35596
2024-02-23,红磡,入境,0,0,0,0
2024-02-23,红磡,出境,0,0,0,0
2024-02-23,罗湖,入境,54198,11447,549,66194
2024-02-23,罗湖,出境,65025,14378,699,80102
2024-02-23,落马洲支线,入境,45068,12836,306,58210
2024-02-23,落马洲支线,出境,56255,13129,366,69750
2024-02-23,香园围,入境,21269,4259,104,25632
2024-02-23,香园围,出境,24329,2850,105,27284
2024-02-23,港珠澳大桥,入境,17351,6827,4488,28666
2024-02-23,港珠澳大桥,出境,23053,8521,4470,36044
2024-02-23,落马洲,入境,9433,2016,221,11670
2024-02-23,落马洲,出境,9637,3426,298,13361
2024-02-23,文锦渡,入境,1425,373,5,1803
2024-02-23,文锦渡,出境,1643,334,12,1989
2024-02-23,沙头角,入境,0,0,0,0
2024-02-23,沙头角,出境,0,0,0,0
2024-02-23,深圳湾,入境,23986,9455,833,34274
2024-02-23,深圳湾,出境,30070,10429,873,41372
2024-02-23,中国客运码头,入境,706,739,295,1740
2024-02-23,中国客运码头,出境,1094,913,341,2348
2024-02-23,港口管制,入境,0,0,40,40
2024-02-23,港口管制,出境,37,0,31,68
2024-02-23,启德邮轮码头,入境,1031,361,111,1503
2024-02-23,启德邮轮码头,出境,1515,135,77,1727
2024-02-23,港澳客轮码头,入境,4817,1252,3014,9083
2024-02-23,港澳客轮码头,出境,5960,1908,2929,10797
2024-02-24,机场,入境,22299,9136,22774,54209
2024-02-24,机场,出境,25730,8979,16026,50735
2024-02-24,高铁西九龙,入境,11430,20400,912,32742
2024-02-24,高铁西九龙,出境,18746,19239,1090,39075
2024-02-24,红磡,入境,0,0,0,0
2024-02-24,红磡,出境,0,0,0,0
2024-02-24,罗湖,入境,79120,15801,523,95444
2024-02-24,罗湖,出境,102112,19551,746,122409
2024-02-24,落马洲支线,入境,65773,20832,400,87005
2024-02-24,落马洲支线,出境,91448,20003,388,111839
2024-02-24,香园围,入境,24352,5446,88,29886
2024-02-24,香园围,出境,31070,3278,93,34441
2024-02-24,港珠澳大桥,入境,20956,6252,6728,33936
2024-02-24,港珠澳大桥,出境,34404,8144,5810,48358
2024-02-24,落马洲,入境,13610,2124,242,15976
2024-02-24,落马洲,出境,13906,3855,436,18197
2024-02-24,文锦渡,入境,996,592,5,1593
2024-02-24,文锦渡,出境,1530,530,8,2068
2024-02-24,沙头角,入境,0,0,0,0
2024-02-24,沙头角,出境,0,0,0,0
2024-02-24,深圳湾,入境,30262,13578,866,44706
2024-02-24,深圳湾,出境,39931,13862,1042,54835
2024-02-24,中国客运码头,入境,725,844,237,1806
2024-02-24,中国客运码头,出境,1254,814,313,2381
2024-02-24,港口管制,入境,19,0,32,51
2024-02-24,港口管制,出境,2,0,58,60
2024-02-24,启德邮轮码头,入境,6,235,3,244
2024-02-24,启德邮轮码头,出境,6,235,3,244
2024-02-24,港澳客轮码头,入境,5022,1059,3637,9718
2024-02-24,港澳客轮码头,出境,7814,1414,3693,12921
2024-02-25,机场,入境,31026,9332,21600,61958
2024-02-25,机场,出境,22713,10120,24805,57638
2024-02-25,高铁西九龙,入境,22725,13286,870,36881
2024-02-25,高铁西九龙,出境,11772,18420,1390,31582
2024-02-25,红磡,入境,0,0,0,0
2024-02-25,红磡,出境,0,0,0,0
2024-02-25,罗湖,入境,96290,13225,632,110147
2024-02-25,罗湖,出境,63343,16635,811,80789
2024-02-25,落马洲支线,入境,75437,15538,396,91371
2024-02-25,落马洲支线,出境,57124,16868,421,74413
2024-02-25,香园围,入境,35053,5201,80,40334
2024-02-25,香园围,出境,26778,3512,117,30407
2024-02-25,港珠澳大桥,入境,39030,6542,6759,52331
2024-02-25,港珠澳大桥,出境,22154,7606,7161,36921
2024-02-25,落马洲,入境,21975,1940,247,24162
2024-02-25,落马洲,出境,10841,3131,522,14494
2024-02-25,文锦渡,入境,1444,426,6,1876
2024-02-25,文锦渡,出境,834,359,4,1197
2024-02-25,沙头角,入境,0,0,0,0
2024-02-25,沙头角,出境,0,0,0,0
2024-02-25,深圳湾,入境,47525,11152,771,59448
2024-02-25,深圳湾,出境,30750,13005,1335,45090
2024-02-25,中国客运码头,入境,1492,663,246,2401
2024-02-25,中国客运码头,出境,695,900,320,1915
2024-02-25,港口管制,入境,30,0,81,111
2024-02-25,港口管制,出境,1,0,29,30
2024-02-25,启德邮轮码头,入境,1525,137,1140,2802
2024-02-25,启德邮轮码头,出境,651,818,142,1611
2024-02-25,港澳客轮码头,入境,7904,898,3095,11897
2024-02-25,港澳客轮码头,出境,4594,1304,3546,9444
2024-02-26,机场,入境,27678,9168,22342,59188
2024-02-26,机场,出境,21242,7140,22227,50609
2024-02-26,高铁西九龙,入境,15844,11633,822,28299
2024-02-26,高铁西九龙,出境,10768,8899,1193,20860
2024-02-26,红磡,入境,0,0,0,0
2024-02-26,红磡,出境,0,0,0,0
2024-02-26,罗湖,入境,61205,11025,546,72776
2024-02-26,罗湖,出境,54582,10694,665,65941
2024-02-26,落马洲支线,入境,49964,10247,299,60510
2024-02-26,落马洲支线,出境,47322,9463,361,57146
2024-02-26,香园围,入境,22640,4445,102,27187
2024-02-26,香园围,出境,21810,2175,122,24107
2024-02-26,港珠澳大桥,入境,19954,5252,4753,29959
2024-02-26,港珠澳大桥,出境,16991,6784,4356,28131
2024-02-26,落马洲,入境,11585,2538,214,14337
2024-02-26,落马洲,出境,7843,2523,595,10961
2024-02-26,文锦渡,入境,1506,354,2,1862
2024-02-26,文锦渡,出境,1408,278,9,1695
2024-02-26,沙头角,入境,0,0,0,0
2024-02-26,沙头角,出境,0,0,0,0
2024-02-26,深圳湾,入境,26999,8400,714,36113
2024-02-26,深圳湾,出境,23453,7418,1162,32033
2024-02-26,中国客运码头,入境,794,608,317,1719
2024-02-26,中国客运码头,出境,755,514,374,1643
2024-02-26,港口管制,入境,9,0,54,63
2024-02-26,港口管制,出境,0,0,39,39
2024-02-26,启德邮轮码头,入境,0,0,0,0
2024-02-26,启德邮轮码头,出境,0,0,0,0
2024-02-26,港澳客轮码头,入境,5158,789,2741,8688
2024-02-26,港澳客轮码头,出境,4331,1047,3169,8547
2024-02-27,机场,入境,25220,7309,20100,52629
2024-02-27,机场,出境,19372,6523,19206,45101
2024-02-27,高铁西九龙,入境,11991,11380,950,24321
2024-02-27,高铁西九龙,出境,10294,10003,1085,21382
2024-02-27,红磡,入境,0,0,0,0
2024-02-27,红磡,出境,0,0,0,0
2024-02-27,罗湖,入境,55924,10269,652,66845
2024-02-27,罗湖,出境,54467,10982,665,66114
2024-02-27,落马洲支线,入境,45973,11364,271,57608
2024-02-27,落马洲支线,出境,46474,10527,355,57356
2024-02-27,香园围,入境,21735,5154,92,26981
2024-02-27,香园围,出境,21967,2477,128,24572
2024-02-27,港珠澳大桥,入境,16874,5215,3751,25840
2024-02-27,港珠澳大桥,出境,16355,7308,3669,27332
2024-02-27,落马洲,入境,9336,2004,240,11580
2024-02-27,落马洲,出境,7683,2422,392,10497
2024-02-27,文锦渡,入境,1351,343,13,1707
2024-02-27,文锦渡,出境,1437,278,12,1727
2024-02-27,沙头角,入境,0,0,0,0
2024-02-27,沙头角,出境,0,0,0,0
2024-02-27,深圳湾,入境,24016,8883,751,33650
2024-02-27,深圳湾,出境,22577,7889,954,31420
2024-02-27,中国客运码头,入境,644,587,256,1487
2024-02-27,中国客运码头,出境,658,700,279,1637
2024-02-27,港口管制,入境,0,0,36,36
2024-02-27,港口管制,出境,38,0,22,60
2024-02-27,启德邮轮码头,入境,766,32,325,1123
2024-02-27,启德邮轮码头,出境,170,1,1007,1178
2024-02-27,港澳客轮码头,入境,4435,684,2276,7395
2024-02-27,港澳客轮码头,出境,4348,1190,2441,7979
2024-02-28,机场,入境,22532,7463,23310,53305
2024-02-28,机场,出境,20651,6867,19092,46610
2024-02-28,高铁西九龙,入境,11532,11402,1155,24089
2024-02-28,高铁西九龙,出境,10210,10289,1064,21563
2024-02-28,红磡,入境,0,0,0,0
2024-02-28,红磡,出境,0,0,0,0
2024-02-28,罗湖,入境,54566,10544,607,65717
2024-02-28,罗湖,出境,53456,11429,784,65669
2024-02-28,落马洲支线,入境,45763,10695,346,56804
2024-02-28,落马洲支线,出境,46054,10443,337,56834
2024-02-28,香园围,入境,21269,5545,106,26920
2024-02-28,香园围,出境,21788,2553,94,24435
2024-02-28,港珠澳大桥,入境,15946,5264,3985,25195
2024-02-28,港珠澳大桥,出境,15166,8461,4002,27629
2024-02-28,落马洲,入境,9044,2095,286,11425
2024-02-28,落马洲,出境,7578,2568,383,10529
2024-02-28,文锦渡,入境,1374,340,10,1724
2024-02-28,文锦渡,出境,1440,335,4,1779
2024-02-28,沙头角,入境,0,0,0,0
2024-02-28,沙头角,出境,0,0,0,0
2024-02-28,深圳湾,入境,23587,8779,881,33247
2024-02-28,深圳湾,出境,21743,7981,933,30657
2024-02-28,中国客运码头,入境,632,589,360,1581
2024-02-28,中国客运码头,出境,642,587,384,1613
2024-02-28,港口管制,入境,1,29,33,63
2024-02-28,港口管制,出境,5,29,39,73
2024-02-28,启德邮轮码头,入境,651,811,140,1602
2024-02-28,启德邮轮码头,出境,1258,821,513,2592
2024-02-28,港澳客轮码头,入境,4407,788,2657,7852
2024-02-28,港澳客轮码头,出境,3970,1268,2830,8068
2024-02-29,机场,入境,21924,7180,20569,49673
2024-02-29,机场,出境,25072,7258,18180,50510
2024-02-29,高铁西九龙,入境,11221,11392,1130,23743
2024-02-29,高铁西九龙,出境,10714,10540,1052,22306
2024-02-29,红磡,入境,0,0,0,0
2024-02-29,红磡,出境,0,0,0,0
2024-02-29,罗湖,入境,55297,10154,741,66192
2024-02-29,罗湖,出境,54264,12027,777,67068
2024-02-29,落马洲支线,入境,46331,10646,359,57336
2024-02-29,落马洲支线,出境,47181,11106,298,58585
2024-02-29,香园围,入境,22118,5371,175,27664
2024-02-29,香园围,出境,22343,2742,94,25179
2024-02-29,港珠澳大桥,入境,15844,5238,3779,24861
2024-02-29,港珠澳大桥,出境,16477,7053,3690,27220
2024-02-29,落马洲,入境,9342,2109,412,11863
2024-02-29,落马洲,出境,7766,2647,414,10827
2024-02-29,文锦渡,入境,1412,366,22,1800
2024-02-29,文锦渡,出境,1500,288,7,1795
2024-02-29,沙头角,入境,0,0,0,0
2024-02-29,沙头角,出境,0,0,0,0
2024-02-29,深圳湾,入境,23230,8435,987,32652
2024-02-29,深圳湾,出境,22563,8147,927,31637
2024-02-29,中国客运码头,入境,608,522,218,1348
2024-02-29,中国客运码头,出境,667,516,245,1428
2024-02-29,港口管制,入境,0,0,29,29
2024-02-29,港口管制,出境,0,0,23,23
2024-02-29,启德邮轮码头,入境,0,0,0,0
2024-02-29,启德邮轮码头,出境,0,0,0,0
2024-02-29,港澳客轮码头,入境,4257,733,2324,7314
2024-02-29,港澳客轮码头,出境,4319,1057,2398,7774
2024-03-01,机场,入境,21754,7837,22277,51868
2024-03-01,机场,出境,32781,7049,17078,56908
2024-03-01,高铁西九龙,入境,11722,13078,1120,25920
2024-03-01,高铁西九龙,出境,18444,11325,1201,30970
2024-03-01,红磡,入境,0,0,0,0
2024-03-01,红磡,出境,0,0,0,0
2024-03-01,罗湖,入境,55371,11485,711,67567
2024-03-01,罗湖,出境,64464,12245,877,77586
2024-03-01,落马洲支线,入境,45372,11760,397,57529
2024-03-01,落马洲支线,出境,56810,11553,311,68674
2024-03-01,香园围,入境,20848,5342,137,26327
2024-03-01,香园围,出境,24000,2631,92,26723
2024-03-01,港珠澳大桥,入境,16612,5576,4397,26585
2024-03-01,港珠澳大桥,出境,23586,9008,4364,36958
2024-03-01,落马洲,入境,9584,2156,404,12144
2024-03-01,落马洲,出境,9538,2923,385,12846
2024-03-01,文锦渡,入境,1339,356,17,1712
2024-03-01,文锦渡,出境,1573,306,13,1892
2024-03-01,沙头角,入境,0,0,0,0
2024-03-01,沙头角,出境,0,0,0,0
2024-03-01,深圳湾,入境,23386,8714,1253,33353
2024-03-01,深圳湾,出境,29703,8075,938,38716
2024-03-01,中国客运码头,入境,703,625,342,1670
2024-03-01,中国客运码头,出境,1036,578,309,1923
2024-03-01,港口管制,入境,3,0,33,36
2024-03-01,港口管制,出境,1,0,22,23
2024-03-01,启德邮轮码头,入境,1216,819,91,2126
2024-03-01,启德邮轮码头,出境,1059,81,50,1190
2024-03-01,港澳客轮码头,入境,4497,755,2789,8041
2024-03-01,港澳客轮码头,出境,5762,1161,2984,9907
2024-03-02,机场,入境,22720,6950,18733,48403
2024-03-02,机场,出境,26943,6330,21134,54407
2024-03-02,高铁西九龙,入境,12287,20875,1288,34450
2024-03-02,高铁西九龙,出境,19733,16738,1336,37807
2024-03-02,红磡,入境,0,0,0,0
2024-03-02,红磡,出境,0,0,0,0
2024-03-02,罗湖,入境,66499,14667,709,81875
2024-03-02,罗湖,出境,86943,17158,812,104913
2024-03-02,落马洲支线,入境,55267,18798,432,74497
2024-03-02,落马洲支线,出境,77459,17988,396,95843
2024-03-02,香园围,入境,25470,7158,102,32730
2024-03-02,香园围,出境,32930,3801,168,36899
2024-03-02,港珠澳大桥,入境,20077,6830,5589,32496
2024-03-02,港珠澳大桥,出境,33367,9362,5104,47833
2024-03-02,落马洲,入境,14126,2201,333,16660
2024-03-02,落马洲,出境,14449,3415,334,18198
2024-03-02,文锦渡,入境,949,481,16,1446
2024-03-02,文锦渡,出境,1418,421,11,1850
2024-03-02,沙头角,入境,0,0,0,0
2024-03-02,沙头角,出境,0,0,0,0
2024-03-02,深圳湾,入境,28567,12962,1084,42613
2024-03-02,深圳湾,出境,37725,12080,1098,50903
2024-03-02,中国客运码头,入境,603,763,262,1628
2024-03-02,中国客运码头,出境,1069,604,276,1949
2024-03-02,港口管制,入境,0,0,103,103
2024-03-02,港口管制,出境,0,0,27,27
2024-03-02,启德邮轮码头,入境,257,215,2236,2708
2024-03-02,启德邮轮码头,出境,238,222,2385,2845
2024-03-02,港澳客轮码头,入境,4616,808,2957,8381
2024-03-02,港澳客轮码头,出境,6926,1190,2950,11066
2024-03-03,机场,入境,29697,6974,16520,53191
2024-03-03,机场,出境,24526,7490,25875,57891
2024-03-03,高铁西九龙,入境,22452,12794,1033,36279
2024-03-03,高铁西九龙,出境,11953,17266,1678,30897
2024-03-03,红磡,入境,0,0,0,0
2024-03-03,红磡,出境,0,0,0,0
2024-03-03,罗湖,入境,93188,12822,743,106753
2024-03-03,罗湖,出境,64792,16198,862,81852
2024-03-03,落马洲支线,入境,74673,15891,378,90942
2024-03-03,落马洲支线,出境,57767,16334,443,74544
2024-03-03,香园围,入境,35728,6752,141,42621
2024-03-03,香园围,出境,28988,3662,153,32803
2024-03-03,港珠澳大桥,入境,37674,5865,5391,48930
2024-03-03,港珠澳大桥,出境,21157,8205,5626,34988
2024-03-03,落马洲,入境,21977,1981,228,24186
2024-03-03,落马洲,出境,10874,3177,518,14569
2024-03-03,文锦渡,入境,1394,428,10,1832
2024-03-03,文锦渡,出境,826,299,6,1131
2024-03-03,沙头角,入境,0,0,0,0
2024-03-03,沙头角,出境,0,0,0,0
2024-03-03,深圳湾,入境,46321,10121,803,57245
2024-03-03,深圳湾,出境,30088,11450,1436,42974
2024-03-03,中国客运码头,入境,1249,539,235,2023
2024-03-03,中国客运码头,出境,589,659,317,1565
2024-03-03,港口管制,入境,0,0,59,59
2024-03-03,港口管制,出境,0,1,43,44
2024-03-03,启德邮轮码头,入境,1058,81,23,1162
2024-03-03,启德邮轮码头,出境,1278,199,301,1778
2024-03-03,港澳客轮码头,入境,7543,796,2595,10934
2024-03-03,港澳客轮码头,出境,4082,1073,2973,8128
2024-03-04,机场,入境,27057,6927,18229,52213
2024-03-04,机场,出境,23466,6065,22167,51698
2024-03-04,高铁西九龙,入境,13057,11153,997,25207
2024-03-04,高铁西九龙,出境,11062,10239,1495,22796
2024-03-04,红磡,入境,0,0,0,0
2024-03-04,红磡,出境,0,0,0,0
2024-03-04,罗湖,入境,58860,11010,675,70545
2024-03-04,罗湖,出境,54682,11248,902,66832
2024-03-04,落马洲支线,入境,47628,10548,299,58475
2024-03-04,落马洲支线,出境,46501,9724,417,56642
2024-03-04,香园围,入境,21690,6172,103,27965
2024-03-04,香园围,出境,21445,2286,170,23901
2024-03-04,港珠澳大桥,入境,18952,5515,3899,28366
2024-03-04,港珠澳大桥,出境,15596,8109,3828,27533
2024-03-04,落马洲,入境,11139,2509,193,13841
2024-03-04,落马洲,出境,7544,2990,535,11069
2024-03-04,文锦渡,入境,1440,343,21,1804
2024-03-04,文锦渡,出境,1614,314,24,1952
2024-03-04,沙头角,入境,0,0,0,0
2024-03-04,沙头角,出境,0,0,0,0
2024-03-04,深圳湾,入境,24861,7925,785,33571
2024-03-04,深圳湾,出境,23154,7590,1269,32013
2024-03-04,中国客运码头,入境,718,464,194,1376
2024-03-04,中国客运码头,出境,774,399,366,1539
2024-03-04,港口管制,入境,0,0,88,88
2024-03-04,港口管制,出境,4,2,24,30
2024-03-04,启德邮轮码头,入境,0,0,2047,2047
2024-03-04,启德邮轮码头,出境,0,0,0,0
2024-03-04,港澳客轮码头,入境,4524,692,2203,7419
2024-03-04,港澳客轮码头,出境,4037,891,2400,7328
2024-03-05,机场,入境,22960,5629,17310,45899
2024-03-05,机场,出境,20034,5869,18646,44549
2024-03-05,高铁西九龙,入境,11106,10157,1037,22300
2024-03-05,高铁西九龙,出境,10405,9260,1186,20851
2024-03-05,红磡,入境,0,0,0,0
2024-03-05,红磡,出境,0,0,0,0
2024-03-05,罗湖,入境,54817,9884,724,65425
2024-03-05,罗湖,出境,54472,10820,864,66156
2024-03-05,落马洲支线,入境,45920,11133,339,57392
2024-03-05,落马洲支线,出境,46383,10548,344,57275
2024-03-05,香园围,入境,22116,4474,67,26657
2024-03-05,香园围,出境,22687,2895,84,25666
2024-03-05,港珠澳大桥,入境,15878,5774,3256,24908
2024-03-05,港珠澳大桥,出境,16332,8731,3590,28653
2024-03-05,落马洲,入境,9190,1918,225,11333
2024-03-05,落马洲,出境,8009,2373,372,10754
2024-03-05,文锦渡,入境,1447,361,16,1824
2024-03-05,文锦渡,出境,1463,308,15,1786
2024-03-05,沙头角,入境,0,0,0,0
2024-03-05,沙头角,出境,0,0,0,0
2024-03-05,深圳湾,入境,22859,7547,802,31208
2024-03-05,深圳湾,出境,22680,7163,1040,30883
2024-03-05,中国客运码头,入境,578,524,165,1267
2024-03-05,中国客运码头,出境,612,494,211,1317
2024-03-05,港口管制,入境,0,0,26,26
2024-03-05,港口管制,出境,2,1,65,68
2024-03-05,启德邮轮码头,入境,0,0,0,0
2024-03-05,启德邮轮码头,出境,0,0,2075,2075
2024-03-05,港澳客轮码头,入境,4314,656,1923,6893
2024-03-05,港澳客轮码头,出境,4144,1049,2514,7707
2024-03-06,机场,入境,21658,6450,16744,44852
2024-03-06,机场,出境,22609,5542,16729,44880
2024-03-06,高铁西九龙,入境,10460,10110,1235,21805
2024-03-06,高铁西九龙,出境,11139,8998,1030,21167
2024-03-06,红磡,入境,0,0,0,0
2024-03-06,红磡,出境,0,0,0,0
2024-03-06,罗湖,入境,54382,9790,703,64875
2024-03-06,罗湖,出境,53783,10673,743,65199
2024-03-06,落马洲支线,入境,44932,10450,311,55693
2024-03-06,落马洲支线,出境,45774,10130,335,56239
2024-03-06,香园围,入境,22054,6348,152,28554
2024-03-06,香园围,出境,22910,3169,86,26165
2024-03-06,港珠澳大桥,入境,15726,5447,4016,25189
2024-03-06,港珠澳大桥,出境,15730,7674,3914,27318
2024-03-06,落马洲,入境,8997,1948,282,11227
2024-03-06,落马洲,出境,7669,2673,376,10718
2024-03-06,文锦渡,入境,1454,344,12,1810
2024-03-06,文锦渡,出境,1541,273,11,1825
2024-03-06,沙头角,入境,0,0,0,0
2024-03-06,沙头角,出境,0,0,0,0
2024-03-06,深圳湾,入境,23000,7638,935,31573
2024-03-06,深圳湾,出境,21977,7591,1015,30583
2024-03-06,中国客运码头,入境,582,413,265,1260
2024-03-06,中国客运码头,出境,707,497,275,1479
2024-03-06,港口管制,入境,1,0,31,32
2024-03-06,港口管制,出境,0,0,30,30
2024-03-06,启德邮轮码头,入境,0,0,105,105
2024-03-06,启德邮轮码头,出境,0,0,110,110
2024-03-06,港澳客轮码头,入境,3902,671,2280,6853
2024-03-06,港澳客轮码头,出境,3896,1076,2666,7638
2024-03-07,机场,入境,20985,7349,19120,47454
2024-03-07,机场,出境,25696,5479,16392,47567
2024-03-07,高铁西九龙,入境,10343,10509,1305,22157
2024-03-07,高铁西九龙,出境,12077,9382,1123,22582
2024-03-07,红磡,入境,0,0,0,0
2024-03-07,红磡,出境,0,0,0,0
2024-03-07,罗湖,入境,55206,9738,751,65695
2024-03-07,罗湖,出境,56153,10715,781,67649
2024-03-07,落马洲支线,入境,45510,11105,353,56968
2024-03-07,落马洲支线,出境,48310,10267,366,58943
2024-03-07,香园围,入境,22797,5840,102,28739
2024-03-07,香园围,出境,24037,2679,138,26854
2024-03-07,港珠澳大桥,入境,16632,5347,3750,25729
2024-03-07,港珠澳大桥,出境,18216,8710,3377,30303
2024-03-07,落马洲,入境,9136,1750,326,11212
2024-03-07,落马洲,出境,7759,2432,324,10515
2024-03-07,文锦渡,入境,1394,314,12,1720
2024-03-07,文锦渡,出境,1451,274,5,1730
2024-03-07,沙头角,入境,0,0,0,0
2024-03-07,沙头角,出境,0,0,0,0
2024-03-07,深圳湾,入境,22997,8322,1024,32343
2024-03-07,深圳湾,出境,24777,7271,949,32997
2024-03-07,中国客运码头,入境,587,439,188,1214
2024-03-07,中国客运码头,出境,670,487,264,1421
2024-03-07,港口管制,入境,3,0,64,67
2024-03-07,港口管制,出境,5,3,53,61
2024-03-07,启德邮轮码头,入境,5,0,602,607
2024-03-07,启德邮轮码头,出境,29,0,612,641
2024-03-07,港澳客轮码头,入境,4230,695,2728,7653
2024-03-07,港澳客轮码头,出境,4558,1006,2112,7676
2024-03-08,机场,入境,25161,9476,20924,55561
2024-03-08,机场,出境,30803,6201,17400,54404
2024-03-08,高铁西九龙,入境,12496,16924,1491,30911
2024-03-08,高铁西九龙,出境,19635,11705,1031,32371
2024-03-08,红磡,入境,0,0,0,0
2024-03-08,红磡,出境,0,0,0,0
2024-03-08,罗湖,入境,60942,12762,815,74519
2024-03-08,罗湖,出境,73106,13370,787,87263
2024-03-08,落马洲支线,入境,49568,14013,431,64012
2024-03-08,落马洲支线,出境,63627,13311,331,77269
2024-03-08,香园围,入境,24193,6811,138,31142
2024-03-08,香园围,出境,28118,3283,169,31570
2024-03-08,港珠澳大桥,入境,18513,6801,5211,30525
2024-03-08,港珠澳大桥,出境,26872,10486,4987,42345
2024-03-08,落马洲,入境,10691,2387,446,13524
2024-03-08,落马洲,出境,10539,2847,279,13665
2024-03-08,文锦渡,入境,1393,406,17,1816
2024-03-08,文锦渡,出境,1659,363,9,2031
2024-03-08,沙头角,入境,0,0,0,0
2024-03-08,沙头角,出境,0,0,0,0
2024-03-08,深圳湾,入境,27249,11092,1403,39744
2024-03-08,深圳湾,出境,34983,9677,874,45534
2024-03-08,中国客运码头,入境,755,914,301,1970
2024-03-08,中国客运码头,出境,1031,656,271,1958
2024-03-08,港口管制,入境,38,0,24,62
2024-03-08,港口管制,出境,1,0,25,26
2024-03-08,启德邮轮码头,入境,1277,198,310,1785
2024-03-08,启德邮轮码头,出境,1242,416,73,1731
2024-03-08,港澳客轮码头,入境,4785,819,2809,8413
2024-03-08,港澳客轮码头,出境,6258,1122,2533,9913
2024-03-09,机场,入境,24868,6976,20104,51948
2024-03-09,机场,出境,26371,6883,17577,50831
2024-03-09,高铁西九龙,入境,13546,23714,1441,38701
2024-03-09,高铁西九龙,出境,20232,19271,1250,40753
2024-03-09,红磡,入境,0,0,0,0
2024-03-09,红磡,出境,0,0,0,0
2024-03-09,罗湖,入境,73506,16689,824,91019
2024-03-09,罗湖,出境,95748,19332,916,115996
2024-03-09,落马洲支线,入境,61577,21604,496,83677
2024-03-09,落马洲支线,出境,85547,20722,453,106722
2024-03-09,香园围,入境,29557,8226,115,37898
2024-03-09,香园围,出境,35918,4720,91,40729
2024-03-09,港珠澳大桥,入境,22998,7328,5766,36092
2024-03-09,港珠澳大桥,出境,36820,10505,5234,52559
2024-03-09,落马洲,入境,15904,2645,499,19048
2024-03-09,落马洲,出境,15865,4060,306,20231
2024-03-09,文锦渡,入境,932,461,16,1409
2024-03-09,文锦渡,出境,1709,383,7,2099
2024-03-09,沙头角,入境,0,0,0,0
2024-03-09,沙头角,出境,0,0,0,0
2024-03-09,深圳湾,入境,32768,14828,1232,48828
2024-03-09,深圳湾,出境,43030,13670,938,57638
2024-03-09,中国客运码头,入境,629,930,271,1830
2024-03-09,中国客运码头,出境,1179,651,253,2083
2024-03-09,港口管制,入境,0,0,43,43
2024-03-09,港口管制,出境,33,0,38,71
2024-03-09,启德邮轮码头,入境,5,0,2109,2114
2024-03-09,启德邮轮码头,出境,0,0,0,0
2024-03-09,港澳客轮码头,入境,5216,969,2882,9067
2024-03-09,港澳客轮码头,出境,7601,1441,2756,11798
2024-03-10,机场,入境,34570,8045,18220,60835
2024-03-10,机场,出境,24576,9011,23123,56710
2024-03-10,高铁西九龙,入境,23216,11920,957,36093
2024-03-10,高铁西九龙,出境,11713,18849,1499,32061
2024-03-10,红磡,入境,0,0,0,0
2024-03-10,红磡,出境,0,0,0,0
2024-03-10,罗湖,入境,98320,11449,744,110513
2024-03-10,罗湖,出境,65622,15332,719,81673
2024-03-10,落马洲支线,入境,79286,14353,400,94039
2024-03-10,落马洲支线,出境,59051,15469,481,75001
2024-03-10,香园围,入境,36301,9974,111,46386
2024-03-10,香园围,出境,29138,4465,125,33728
2024-03-10,港珠澳大桥,入境,41488,6480,5590,53558
2024-03-10,港珠澳大桥,出境,22866,9103,6142,38111
2024-03-10,落马洲,入境,23802,1938,325,26065
2024-03-10,落马洲,出境,10902,3227,502,14631
2024-03-10,文锦渡,入境,1412,340,13,1765
2024-03-10,文锦渡,出境,831,317,9,1157
2024-03-10,沙头角,入境,0,0,0,0
2024-03-10,沙头角,出境,0,0,0,0
2024-03-10,深圳湾,入境,48879,9850,904,59633
2024-03-10,深圳湾,出境,30531,12257,1221,44009
2024-03-10,中国客运码头,入境,1399,507,264,2170
2024-03-10,中国客运码头,出境,634,842,385,1861
2024-03-10,港口管制,入境,0,0,82,82
2024-03-10,港口管制,出境,0,0,16,16
2024-03-10,启德邮轮码头,入境,1281,420,4491,6192
2024-03-10,启德邮轮码头,出境,708,1023,4901,6632
2024-03-10,港澳客轮码头,入境,7883,783,2429,11095
2024-03-10,港澳客轮码头,出境,4082,1090,2873,8045
2024-03-11,机场,入境,27722,7379,19020,54121
2024-03-11,机场,出境,23610,6365,18498,48473
2024-03-11,高铁西九龙,入境,13811,9929,943,24683
2024-03-11,高铁西九龙,出境,11633,8496,1278,21407
2024-03-11,红磡,入境,0,0,0,0
2024-03-11,红磡,出境,0,0,0,0
2024-03-11,罗湖,入境,57059,9348,602,67009
2024-03-11,罗湖,出境,52435,9650,705,62790
2024-03-11,落马洲支线,入境,46292,8828,299,55419
2024-03-11,落马洲支线,出境,44519,8416,371,53306
2024-03-11,香园围,入境,19247,6575,56,25878
2024-03-11,香园围,出境,19271,2396,140,21807
2024-03-11,港珠澳大桥,入境,19280,5801,3632,28713
2024-03-11,港珠澳大桥,出境,15520,10594,3637,29751
2024-03-11,落马洲,入境,10949,2419,276,13644
2024-03-11,落马洲,出境,7520,2336,550,10406
2024-03-11,文锦渡,入境,1411,237,5,1653
2024-03-11,文锦渡,出境,1408,175,10,1593
2024-03-11,沙头角,入境,0,0,0,0
2024-03-11,沙头角,出境,0,0,0,0
2024-03-11,深圳湾,入境,23430,7346,701,31477
2024-03-11,深圳湾,出境,21681,6380,1213,29274
2024-03-11,中国客运码头,入境,682,409,249,1340
2024-03-11,中国客运码头,出境,694,439,324,1457
2024-03-11,港口管制,入境,4,15,68,87
2024-03-11,港口管制,出境,3,15,72,90
2024-03-11,启德邮轮码头,入境,0,0,0,0
2024-03-11,启德邮轮码头,出境,3,0,1753,1756
2024-03-11,港澳客轮码头,入境,4751,665,2144,7560
2024-03-11,港澳客轮码头,出境,3995,897,2231,7123
2024-03-12,机场,入境,23911,6156,15521,45588
2024-03-12,机场,出境,21343,5525,16612,43480
2024-03-12,高铁西九龙,入境,11338,11720,953,24011
2024-03-12,高铁西九龙,出境,10729,10022,1093,21844
2024-03-12,红磡,入境,0,0,0,0
2024-03-12,红磡,出境,0,0,0,0
2024-03-12,罗湖,入境,57745,10993,642,69380
2024-03-12,罗湖,出境,57385,11762,691,69838
2024-03-12,落马洲支线,入境,48409,11968,339,60716
2024-03-12,落马洲支线,出境,49461,11594,380,61435
2024-03-12,香园围,入境,24781,7848,96,32725
2024-03-12,香园围,出境,25692,3355,141,29188
2024-03-12,港珠澳大桥,入境,16989,6936,3632,27557
2024-03-12,港珠澳大桥,出境,17341,11516,3704,32561
2024-03-12,落马洲,入境,9053,2080,262,11395
2024-03-12,落马洲,出境,7878,2402,443,10723
2024-03-12,文锦渡,入境,1477,406,19,1902
2024-03-12,文锦渡,出境,1487,329,20,1836
2024-03-12,沙头角,入境,0,0,0,0
2024-03-12,沙头角,出境,0,0,0,0
2024-03-12,深圳湾,入境,25169,8593,775,34537
2024-03-12,深圳湾,出境,24986,7921,1018,33925
2024-03-12,中国客运码头,入境,557,577,223,1357
2024-03-12,中国客运码头,出境,663,518,198,1379
2024-03-12,港口管制,入境,0,0,64,64
2024-03-12,港口管制,出境,0,2,39,41
2024-03-12,启德邮轮码头,入境,0,0,0,0
2024-03-12,启德邮轮码头,出境,0,0,0,0
2024-03-12,港澳客轮码头,入境,4373,812,1864,7049
2024-03-12,港澳客轮码头,出境,4285,1125,2018,7428
2024-03-13,机场,入境,22538,7243,17932,47713
2024-03-13,机场,出境,23214,6059,15861,45134
2024-03-13,高铁西九龙,入境,10694,11225,1027,22946
2024-03-13,高铁西九龙,出境,12352,9868,1059,23279
2024-03-13,红磡,入境,0,0,0,0
2024-03-13,红磡,出境,0,0,0,0
2024-03-13,罗湖,入境,56192,10807,580,67579
2024-03-13,罗湖,出境,56275,11062,693,68030
2024-03-13,落马洲支线,入境,46769,10944,297,58010
2024-03-13,落马洲支线,出境,48171,10628,333,59132
2024-03-13,香园围,入境,22868,10392,92,33352
2024-03-13,香园围,出境,23704,3204,124,27032
2024-03-13,港珠澳大桥,入境,15906,6080,3734,25720
2024-03-13,港珠澳大桥,出境,16462,11614,4032,32108
2024-03-13,落马洲,入境,9654,1989,329,11972
2024-03-13,落马洲,出境,7984,2560,365,10909
2024-03-13,文锦渡,入境,1502,329,9,1840
2024-03-13,文锦渡,出境,1467,276,9,1752
2024-03-13,沙头角,入境,0,0,0,0
2024-03-13,沙头角,出境,0,0,0,0
2024-03-13,深圳湾,入境,24054,8427,838,33319
2024-03-13,深圳湾,出境,24707,7387,996,33090
2024-03-13,中国客运码头,入境,584,590,239,1413
2024-03-13,中国客运码头,出境,698,550,318,1566
2024-03-13,港口管制,入境,0,0,123,123
2024-03-13,港口管制,出境,2,0,34,36
2024-03-13,启德邮轮码头,入境,739,1040,2391,4170
2024-03-13,启德邮轮码头,出境,898,1254,53,2205
2024-03-13,港澳客轮码头,入境,4049,835,2316,7200
2024-03-13,港澳客轮码头,出境,3907,1378,2346,7631
2024-03-14,机场,入境,20590,7546,18476,46612
2024-03-14,机场,出境,27507,6783,15991,50281
2024-03-14,高铁西九龙,入境,11152,11354,1203,23709
2024-03-14,高铁西九龙,出境,13020,9801,1130,23951
2024-03-14,红磡,入境,0,0,0,0
2024-03-14,红磡,出境,0,0,0,0
2024-03-14,罗湖,入境,56862,10030,639,67531
2024-03-14,罗湖,出境,56918,11363,651,68932
2024-03-14,落马洲支线,入境,47757,11302,429,59488
2024-03-14,落马洲支线,出境,49656,10845,346,60847
2024-03-14,香园围,入境,24004,8349,105,32458
2024-03-14,香园围,出境,25177,3141,117,28435
2024-03-14,港珠澳大桥,入境,16925,6310,3437,26672
2024-03-14,港珠澳大桥,出境,18437,12803,3503,34743
2024-03-14,落马洲,入境,9439,1909,343,11691
2024-03-14,落马洲,出境,8131,2368,383,10882
2024-03-14,文锦渡,入境,1464,278,13,1755
2024-03-14,文锦渡,出境,1523,243,10,1776
2024-03-14,沙头角,入境,0,0,0,0
2024-03-14,沙头角,出境,0,0,0,0
2024-03-14,深圳湾,入境,24708,8153,978,33839
2024-03-14,深圳湾,出境,25317,7517,937,33771
2024-03-14,中国客运码头,入境,616,552,236,1404
2024-03-14,中国客运码头,出境,660,602,275,1537
2024-03-14,港口管制,入境,2,0,111,113
2024-03-14,港口管制,出境,0,0,55,55
2024-03-14,启德邮轮码头,入境,0,0,567,567
2024-03-14,启德邮轮码头,出境,168,13,2318,2499
2024-03-14,港澳客轮码头,入境,4358,924,2034,7316
2024-03-14,港澳客轮码头,出境,4668,1250,2086,8004
2024-03-15,机场,入境,25646,9097,21232,55975
2024-03-15,机场,出境,30763,6945,17849,55557
2024-03-15,高铁西九龙,入境,13729,15330,1538,30597
2024-03-15,高铁西九龙,出境,19959,11735,1160,32854
2024-03-15,红磡,入境,0,0,0,0
2024-03-15,红磡,出境,0,0,0,0
2024-03-15,罗湖,入境,60029,11450,748,72227
2024-03-15,罗湖,出境,69724,12953,731,83408
2024-03-15,落马洲支线,入境,49337,12421,404,62162
2024-03-15,落马洲支线,出境,61372,11713,319,73404
2024-03-15,香园围,入境,24648,6244,132,31024
2024-03-15,香园围,出境,28092,4473,149,32714
2024-03-15,港珠澳大桥,入境,18325,6964,3972,29261
2024-03-15,港珠澳大桥,出境,29702,12271,4207,46180
2024-03-15,落马洲,入境,10257,2354,519,13130
2024-03-15,落马洲,出境,10530,2911,354,13795
2024-03-15,文锦渡,入境,1404,335,9,1748
2024-03-15,文锦渡,出境,1682,309,11,2002
2024-03-15,沙头角,入境,0,0,0,0
2024-03-15,沙头角,出境,0,0,0,0
2024-03-15,深圳湾,入境,27733,9759,1275,38767
2024-03-15,深圳湾,出境,35345,9753,1074,46172
2024-03-15,中国客运码头,入境,750,752,252,1754
2024-03-15,中国客运码头,出境,1079,674,297,2050
2024-03-15,港口管制,入境,2,0,33,35
2024-03-15,港口管制,出境,2,0,46,48
2024-03-15,启德邮轮码头,入境,1066,1261,2693,5020
2024-03-15,启德邮轮码头,出境,1367,420,3546,5333
2024-03-15,港澳客轮码头,入境,4829,901,2536,8266
2024-03-15,港澳客轮码头,出境,6905,1228,2523,10656
2024-03-16,机场,入境,24928,8108,19482,52518
2024-03-16,机场,出境,26739,6443,17944,51126
2024-03-16,高铁西九龙,入境,13877,30266,1528,45671
2024-03-16,高铁西九龙,出境,21183,20134,1226,42543
2024-03-16,红磡,入境,0,0,0,0
2024-03-16,红磡,出境,0,0,0,0
2024-03-16,罗湖,入境,73528,19609,754,93891
2024-03-16,罗湖,出境,96866,23058,829,120753
2024-03-16,落马洲支线,入境,62070,26877,523,89470
2024-03-16,落马洲支线,出境,86592,24620,472,111684
2024-03-16,香园围,入境,29319,11949,158,41426
2024-03-16,香园围,出境,37846,4937,107,42890
2024-03-16,港珠澳大桥,入境,24632,9065,6135,39832
2024-03-16,港珠澳大桥,出境,42534,13332,5347,61213
2024-03-16,落马洲,入境,15478,2916,392,18786
2024-03-16,落马洲,出境,15696,5886,371,21953
2024-03-16,文锦渡,入境,897,568,10,1475
2024-03-16,文锦渡,出境,1335,467,5,1807
2024-03-16,沙头角,入境,0,0,0,0
2024-03-16,沙头角,出境,0,0,0,0
2024-03-16,深圳湾,入境,32380,17942,1189,51511
2024-03-16,深圳湾,出境,44502,15248,1019,60769
2024-03-16,中国客运码头,入境,756,996,308,2060
2024-03-16,中国客运码头,出境,1179,724,316,2219
2024-03-16,港口管制,入境,0,0,86,86
2024-03-16,港口管制,出境,26,1,45,72
2024-03-16,启德邮轮码头,入境,14,222,1189,1425
2024-03-16,启德邮轮码头,出境,9,218,5,232
2024-03-16,港澳客轮码头,入境,5479,1233,2949,9661
2024-03-16,港澳客轮码头,出境,8651,1467,2967,13085
2024-03-17,机场,入境,32985,8078,17991,59054
2024-03-17,机场,出境,26086,9103,23454,58643
2024-03-17,高铁西九龙,入境,23935,16769,1150,41854
2024-03-17,高铁西九龙,出境,12608,23546,1644,37798
2024-03-17,红磡,入境,0,0,0,0
2024-03-17,红磡,出境,0,0,0,0
2024-03-17,罗湖,入境,104558,14142,784,119484
2024-03-17,罗湖,出境,71652,19393,822,91867
2024-03-17,落马洲支线,入境,84329,18417,407,103153
2024-03-17,落马洲支线,出境,65512,19575,500,85587
2024-03-17,香园围,入境,39042,12799,122,51963
2024-03-17,香园围,出境,32958,5174,141,38273
2024-03-17,港珠澳大桥,入境,50271,7193,5691,63155
2024-03-17,港珠澳大桥,出境,25475,12521,6338,44334
2024-03-17,落马洲,入境,24682,2440,276,27398
2024-03-17,落马洲,出境,12205,4394,560,17159
2024-03-17,文锦渡,入境,1420,392,8,1820
2024-03-17,文锦渡,出境,1132,341,11,1484
2024-03-17,沙头角,入境,0,0,0,0
2024-03-17,沙头角,出境,0,0,0,0
2024-03-17,深圳湾,入境,54098,12018,872,66988
2024-03-17,深圳湾,出境,34898,13637,1495,50030
2024-03-17,中国客运码头,入境,1284,657,198,2139
2024-03-17,中国客运码头,出境,704,933,328,1965
2024-03-17,港口管制,入境,0,0,42,42
2024-03-17,港口管制,出境,1,0,26,27
2024-03-17,启德邮轮码头,入境,1276,411,133,1820
2024-03-17,启德邮轮码头,出境,731,1310,1406,3447
2024-03-17,港澳客轮码头,入境,9480,1002,2328,12810
2024-03-17,港澳客轮码头,出境,5186,1306,3100,9592
2024-03-18,机场,入境,27804,8712,18194,54710
2024-03-18,机场,出境,26340,7602,18965,52907
2024-03-18,高铁西九龙,入境,14685,13237,1191,29113
2024-03-18,高铁西九龙,出境,12428,11106,1459,24993
2024-03-18,红磡,入境,0,0,0,0
2024-03-18,红磡,出境,0,0,0,0
2024-03-18,罗湖,入境,62316,11844,699,74859
2024-03-18,罗湖,出境,56490,12005,754,69249
2024-03-18,落马洲支线,入境,50453,11660,319,62432
2024-03-18,落马洲支线,出境,48552,10616,396,59564
2024-03-18,香园围,入境,23409,10204,156,33769
2024-03-18,香园围,出境,22840,3311,185,26336
2024-03-18,港珠澳大桥,入境,22512,7357,4498,34367
2024-03-18,港珠澳大桥,出境,17331,14063,3813,35207
2024-03-18,落马洲,入境,12028,2852,262,15142
2024-03-18,落马洲,出境,7945,2820,584,11349
2024-03-18,文锦渡,入境,1412,375,9,1796
2024-03-18,文锦渡,出境,1553,288,19,1860
2024-03-18,沙头角,入境,0,0,0,0
2024-03-18,沙头角,出境,0,0,0,0
2024-03-18,深圳湾,入境,28739,10017,1011,39767
2024-03-18,深圳湾,出境,24855,8656,1548,35059
2024-03-18,中国客运码头,入境,697,376,244,1317
2024-03-18,中国客运码头,出境,618,416,233,1267
2024-03-18,港口管制,入境,4,6,24,34
2024-03-18,港口管制,出境,95,0,47,142
2024-03-18,启德邮轮码头,入境,0,0,0,0
2024-03-18,启德邮轮码头,出境,0,0,0,0
2024-03-18,港澳客轮码头,入境,5545,839,2192,8576
2024-03-18,港澳客轮码头,出境,4123,1132,2452,7707
2024-03-19,机场,入境,24541,7126,14377,46044
2024-03-19,机场,出境,23371,6943,16361,46675
2024-03-19,高铁西九龙,入境,11220,11715,1153,24088
2024-03-19,高铁西九龙,出境,11267,10784,1222,23273
2024-03-19,红磡,入境,0,0,0,0
2024-03-19,红磡,出境,0,0,0,0
2024-03-19,罗湖,入境,55631,9953,640,66224
2024-03-19,罗湖,出境,55745,11261,712,67718
2024-03-19,落马洲支线,入境,46153,10505,305,56963
2024-03-19,落马洲支线,出境,47211,10037,292,57540
2024-03-19,香园围,入境,22477,10099,94,32670
2024-03-19,香园围,出境,23196,3323,131,26650
2024-03-19,港珠澳大桥,入境,16827,6506,3525,26858
2024-03-19,港珠澳大桥,出境,16438,13527,3672,33637
2024-03-19,落马洲,入境,10388,1966,301,12655
2024-03-19,落马洲,出境,9457,2452,406,12315
2024-03-19,文锦渡,入境,1360,329,30,1719
2024-03-19,文锦渡,出境,1455,304,10,1769
2024-03-19,沙头角,入境,0,0,0,0
2024-03-19,沙头角,出境,0,0,0,0
2024-03-19,深圳湾,入境,24205,9260,926,34391
2024-03-19,深圳湾,出境,23197,7891,1138,32226
2024-03-19,中国客运码头,入境,541,509,197,1247
2024-03-19,中国客运码头,出境,686,719,241,1646
2024-03-19,港口管制,入境,0,0,72,72
2024-03-19,港口管制,出境,0,0,28,28
2024-03-19,启德邮轮码头,入境,9,0,1859,1868
2024-03-19,启德邮轮码头,出境,0,0,0,0
2024-03-19,港澳客轮码头,入境,4140,783,1963,6886
2024-03-19,港澳客轮码头,出境,3886,1293,2041,7220
2024-03-20,机场,入境,23746,8716,16816,49278
2024-03-20,机场,出境,28184,7299,17065,52548
2024-03-20,高铁西九龙,入境,11440,12573,1395,25408
2024-03-20,高铁西九龙,出境,12762,11551,1245,25558
2024-03-20,红磡,入境,0,0,0,0
2024-03-20,红磡,出境,0,0,0,0
2024-03-20,罗湖,入境,57237,10703,690,68630
2024-03-20,罗湖,出境,56765,11684,667,69116
2024-03-20,落马洲支线,入境,47319,11675,313,59307
2024-03-20,落马洲支线,出境,48885,11345,358,60588
2024-03-20,香园围,入境,23257,10644,105,34006
2024-03-20,香园围,出境,24016,3852,119,27987
2024-03-20,港珠澳大桥,入境,16682,7478,4025,28185
2024-03-20,港珠澳大桥,出境,16648,14184,4216,35048
2024-03-20,落马洲,入境,9642,2152,370,12164
2024-03-20,落马洲,出境,8349,2537,394,11280
2024-03-20,文锦渡,入境,1382,422,10,1814
2024-03-20,文锦渡,出境,1491,328,14,1833
2024-03-20,沙头角,入境,0,0,0,0
2024-03-20,沙头角,出境,0,0,0,0
2024-03-20,深圳湾,入境,24291,8989,1062,34342
2024-03-20,深圳湾,出境,24368,8172,1224,33764
2024-03-20,中国客运码头,入境,570,684,219,1473
2024-03-20,中国客运码头,出境,701,713,289,1703
2024-03-20,港口管制,入境,0,0,17,17
2024-03-20,港口管制,出境,0,4,38,42
2024-03-20,启德邮轮码头,入境,0,0,0,0
2024-03-20,启德邮轮码头,出境,17,0,1887,1904
2024-03-20,港澳客轮码头,入境,4166,922,2148,7236
2024-03-20,港澳客轮码头,出境,4008,1536,2280,7824
2024-03-21,机场,入境,23106,8947,17690,49743
2024-03-21,机场,出境,32683,6946,16576,56205
2024-03-21,高铁西九龙,入境,11689,13240,1518,26447
2024-03-21,高铁西九龙,出境,13644,12055,1306,27005
2024-03-21,红磡,入境,0,0,0,0
2024-03-21,红磡,出境,0,0,0,0
2024-03-21,罗湖,入境,57941,10356,713,69010
2024-03-21,罗湖,出境,57094,11765,765,69624
2024-03-21,落马洲支线,入境,47782,11727,410,59919
2024-03-21,落马洲支线,出境,50079,11564,359,62002
2024-03-21,香园围,入境,24422,9287,122,33831
2024-03-21,香园围,出境,26017,3602,130,29749
2024-03-21,港珠澳大桥,入境,16793,6978,3698,27469
2024-03-21,港珠澳大桥,出境,18354,14782,3543,36679
2024-03-21,落马洲,入境,9776,2104,406,12286
2024-03-21,落马洲,出境,8057,2615,365,11037
2024-03-21,文锦渡,入境,1400,284,10,1694
2024-03-21,文锦渡,出境,1495,251,7,1753
2024-03-21,沙头角,入境,0,0,0,0
2024-03-21,沙头角,出境,0,0,0,0
2024-03-21,深圳湾,入境,24695,9081,1196,34972
2024-03-21,深圳湾,出境,26060,8785,1022,35867
2024-03-21,中国客运码头,入境,673,575,252,1500
2024-03-21,中国客运码头,出境,798,703,246,1747
2024-03-21,港口管制,入境,0,0,20,20
2024-03-21,港口管制,出境,3,0,10,13
2024-03-21,启德邮轮码头,入境,0,0,0,0
2024-03-21,启德邮轮码头,出境,0,0,0,0
2024-03-21,港澳客轮码头,入境,4385,930,2003,7318
2024-03-21,港澳客轮码头,出境,4406,1280,2088,7774
2024-03-22,机场,入境,27628,11142,20093,58863
2024-03-22,机场,出境,39981,7321,16783,64085
2024-03-22,高铁西九龙,入境,14422,19759,1625,35806
2024-03-22,高铁西九龙,出境,21350,12571,1169,35090
2024-03-22,红磡,入境,0,0,0,0
2024-03-22,红磡,出境,0,0,0,0
2024-03-22,罗湖,入境,59954,12900,751,73605
2024-03-22,罗湖,出境,71436,13361,786,85583
2024-03-22,落马洲支线,入境,50394,14082,383,64859
2024-03-22,落马洲支线,出境,61614,12741,317,74672
2024-03-22,香园围,入境,24853,8776,170,33799
2024-03-22,香园围,出境,28354,3614,183,32151
2024-03-22,港珠澳大桥,入境,18993,7389,4389,30771
2024-03-22,港珠澳大桥,出境,27218,14112,4304,45634
2024-03-22,落马洲,入境,10449,2661,556,13666
2024-03-22,落马洲,出境,10687,3288,361,14336
2024-03-22,文锦渡,入境,1460,364,12,1836
2024-03-22,文锦渡,出境,1665,300,15,1980
2024-03-22,沙头角,入境,0,0,0,0
2024-03-22,沙头角,出境,0,0,0,0
2024-03-22,深圳湾,入境,27799,11213,1521,40533
2024-03-22,深圳湾,出境,34448,10251,905,45604
2024-03-22,中国客运码头,入境,746,708,290,1744
2024-03-22,中国客运码头,出境,980,676,228,1884
2024-03-22,港口管制,入境,21,2,49,72
2024-03-22,港口管制,出境,4,0,21,25
2024-03-22,启德邮轮码头,入境,728,1310,690,2728
2024-03-22,启德邮轮码头,出境,1322,272,743,2337
2024-03-22,港澳客轮码头,入境,5011,959,2319,8289
2024-03-22,港澳客轮码头,出境,6221,1483,2412,10116
2024-03-23,机场,入境,27123,9473,18821,55417
2024-03-23,机场,出境,41572,6190,15731,63493
2024-03-23,高铁西九龙,入境,14295,33165,1416,48876
2024-03-23,高铁西九龙,出境,25705,21911,1094,48710
2024-03-23,红磡,入境,0,0,0,0
2024-03-23,红磡,出境,0,0,0,0
2024-03-23,罗湖,入境,72580,20265,829,93674
2024-03-23,罗湖,出境,97661,23874,876,122411
2024-03-23,落马洲支线,入境,61049,28000,558,89607
2024-03-23,落马洲支线,出境,85772,24957,529,111258
2024-03-23,香园围,入境,30161,11424,149,41734
2024-03-23,香园围,出境,38187,5694,112,43993
2024-03-23,港珠澳大桥,入境,23578,9273,6259,39110
2024-03-23,港珠澳大桥,出境,38112,14194,5681,57987
2024-03-23,落马洲,入境,15783,3275,457,19515
2024-03-23,落马洲,出境,15778,7696,341,23815
2024-03-23,文锦渡,入境,992,1093,31,2116
2024-03-23,文锦渡,出境,1623,758,13,2394
2024-03-23,沙头角,入境,0,0,0,0
2024-03-23,沙头角,出境,0,0,0,0
2024-03-23,深圳湾,入境,34056,18098,1363,53517
2024-03-23,深圳湾,出境,47088,16140,960,64188
2024-03-23,中国客运码头,入境,688,1312,332,2332
2024-03-23,中国客运码头,出境,1259,903,283,2445
2024-03-23,港口管制,入境,0,0,20,20
2024-03-23,港口管制,出境,0,0,25,25
2024-03-23,启德邮轮码头,入境,0,0,0,0
2024-03-23,启德邮轮码头,出境,0,0,0,0
2024-03-23,港澳客轮码头,入境,5340,1159,2626,9125
2024-03-23,港澳客轮码头,出境,7698,1593,2795,12086
2024-03-24,机场,入境,34618,9402,16527,60547
2024-03-24,机场,出境,36003,9664,20353,66020
2024-03-24,高铁西九龙,入境,23419,18267,1220,42906
2024-03-24,高铁西九龙,出境,15793,26536,1470,43799
2024-03-24,红磡,入境,0,0,0,0
2024-03-24,红磡,出境,0,0,0,0
2024-03-24,罗湖,入境,98024,14649,697,113370
2024-03-24,罗湖,出境,69128,20433,717,90278
2024-03-24,落马洲支线,入境,77688,18789,397,96874
2024-03-24,落马洲支线,出境,61708,19894,410,82012
2024-03-24,香园围,入境,37273,12715,174,50162
2024-03-24,香园围,出境,31423,5382,199,37004
2024-03-24,港珠澳大桥,入境,40993,9538,5565,56096
2024-03-24,港珠澳大桥,出境,23981,14202,6123,44306
2024-03-24,落马洲,入境,23218,2472,334,26024
2024-03-24,落马洲,出境,11918,8473,472,20863
2024-03-24,文锦渡,入境,1447,457,8,1912
2024-03-24,文锦渡,出境,1066,355,11,1432
2024-03-24,沙头角,入境,0,0,0,0
2024-03-24,沙头角,出境,0,0,0,0
2024-03-24,深圳湾,入境,51081,12132,1107,64320
2024-03-24,深圳湾,出境,34236,15080,1171,50487
2024-03-24,中国客运码头,入境,1307,678,238,2223
2024-03-24,中国客运码头,出境,699,1114,274,2087
2024-03-24,港口管制,入境,0,0,64,64
2024-03-24,港口管制,出境,1,0,22,23
2024-03-24,启德邮轮码头,入境,1316,272,2089,3677
2024-03-24,启德邮轮码头,出境,1115,870,77,2062
2024-03-24,港澳客轮码头,入境,7861,1055,2035,10951
2024-03-24,港澳客轮码头,出境,4542,1395,2801,8738
2024-03-25,机场,入境,28088,10130,16139,54357
2024-03-25,机场,出境,35667,8482,18237,62386
2024-03-25,高铁西九龙,入境,14809,12826,954,28589
2024-03-25,高铁西九龙,出境,17618,13261,1400,32279
2024-03-25,红磡,入境,0,0,0,0
2024-03-25,红磡,出境,0,0,0,0
2024-03-25,罗湖,入境,63132,11596,653,75381
2024-03-25,罗湖,出境,61113,12488,738,74339
2024-03-25,落马洲支线,入境,51922,11464,322,63708
2024-03-25,落马洲支线,出境,51486,10678,384,62548
2024-03-25,香园围,入境,24611,10836,92,35539
2024-03-25,香园围,出境,26026,3213,151,29390
2024-03-25,港珠澳大桥,入境,21600,7114,4060,32774
2024-03-25,港珠澳大桥,出境,20575,13885,3633,38093
2024-03-25,落马洲,入境,12107,2831,307,15245
2024-03-25,落马洲,出境,8714,6396,511,15621
2024-03-25,文锦渡,入境,1384,366,9,1759
2024-03-25,文锦渡,出境,1288,284,7,1579
2024-03-25,沙头角,入境,0,0,0,0
2024-03-25,沙头角,出境,0,0,0,0
2024-03-25,深圳湾,入境,27790,8885,924,37599
2024-03-25,深圳湾,出境,27338,8959,1171,37468
2024-03-25,中国客运码头,入境,715,631,284,1630
2024-03-25,中国客运码头,出境,769,621,285,1675
2024-03-25,港口管制,入境,0,0,21,21
2024-03-25,港口管制,出境,6,1,32,39
2024-03-25,启德邮轮码头,入境,0,0,0,0
2024-03-25,启德邮轮码头,出境,0,0,2052,2052
2024-03-25,港澳客轮码头,入境,5203,810,2003,8016
2024-03-25,港澳客轮码头,出境,4783,1226,2194,8203
2024-03-26,机场,入境,27294,8816,16077,52187
2024-03-26,机场,出境,46016,6051,14628,66695
2024-03-26,高铁西九龙,入境,14380,12935,937,28252
2024-03-26,高铁西九龙,出境,19025,12247,1364,32636
2024-03-26,红磡,入境,0,0,0,0
2024-03-26,红磡,出境,0,0,0,0
2024-03-26,罗湖,入境,59467,11174,617,71258
2024-03-26,罗湖,出境,63726,12387,707,76820
2024-03-26,落马洲支线,入境,47972,11215,332,59519
2024-03-26,落马洲支线,出境,54085,11549,355,65989
2024-03-26,香园围,入境,24942,9484,112,34538
2024-03-26,香园围,出境,26733,3749,138,30620
2024-03-26,港珠澳大桥,入境,18897,6998,3476,29371
2024-03-26,港珠澳大桥,出境,21688,15142,3538,40368
2024-03-26,落马洲,入境,9586,2051,285,11922
2024-03-26,落马洲,出境,8855,2919,349,12123
2024-03-26,文锦渡,入境,1381,338,3,1722
2024-03-26,文锦渡,出境,1477,277,11,1765
2024-03-26,沙头角,入境,0,0,0,0
2024-03-26,沙头角,出境,0,0,0,0
2024-03-26,深圳湾,入境,26023,9031,878,35932
2024-03-26,深圳湾,出境,29579,8928,1112,39619
2024-03-26,中国客运码头,入境,624,678,269,1571
2024-03-26,中国客运码头,出境,902,648,249,1799
2024-03-26,港口管制,入境,5,0,99,104
2024-03-26,港口管制,出境,101,16,100,217
2024-03-26,启德邮轮码头,入境,1114,867,3609,5590
2024-03-26,启德邮轮码头,出境,939,863,76,1878
2024-03-26,港澳客轮码头,入境,4929,785,2052,7766
2024-03-26,港澳客轮码头,出境,4659,1307,2296,8262
2024-03-27,机场,入境,27102,9013,19842,55957
2024-03-27,机场,出境,55493,4736,14656,74885
2024-03-27,高铁西九龙,入境,14061,12835,1094,27990
2024-03-27,高铁西九龙,出境,31369,13692,1377,46438
2024-03-27,红磡,入境,0,0,0,0
2024-03-27,红磡,出境,0,0,0,0
2024-03-27,罗湖,入境,58945,10640,603,70188
2024-03-27,罗湖,出境,71870,13139,740,85749
2024-03-27,落马洲支线,入境,48144,11070,325,59539
2024-03-27,落马洲支线,出境,61913,11818,338,74069
2024-03-27,香园围,入境,24772,10598,107,35477
2024-03-27,香园围,出境,27827,3683,125,31635
2024-03-27,港珠澳大桥,入境,19100,6836,3666,29602
2024-03-27,港珠澳大桥,出境,28346,14655,3963,46964
2024-03-27,落马洲,入境,10122,2173,338,12633
2024-03-27,落马洲,出境,10218,3126,427,13771
2024-03-27,文锦渡,入境,1231,348,6,1585
2024-03-27,文锦渡,出境,1404,318,19,1741
2024-03-27,沙头角,入境,0,0,0,0
2024-03-27,沙头角,出境,0,0,0,0
2024-03-27,深圳湾,入境,26499,8482,889,35870
2024-03-27,深圳湾,出境,37648,10105,1101,48854
2024-03-27,中国客运码头,入境,628,662,239,1529
2024-03-27,中国客运码头,出境,1148,738,286,2172
2024-03-27,港口管制,入境,7,0,120,127
2024-03-27,港口管制,出境,0,1,32,33
2024-03-27,启德邮轮码头,入境,15,20,1675,1710
2024-03-27,启德邮轮码头,出境,0,0,0,0
2024-03-27,港澳客轮码头,入境,4734,837,1799,7370
2024-03-27,港澳客轮码头,出境,5395,1341,1906,8642
2024-03-28,机场,入境,29406,8711,20092,58209
2024-03-28,机场,出境,66294,3675,11822,81791
2024-03-28,高铁西九龙,入境,12995,13297,936,27228
2024-03-28,高铁西九龙,出境,59037,11143,1215,71395
2024-03-28,红磡,入境,0,0,0,0
2024-03-28,红磡,出境,0,0,0,0
2024-03-28,罗湖,入境,57156,10223,623,68002
2024-03-28,罗湖,出境,114544,16362,1045,131951
2024-03-28,落马洲支线,入境,45823,11126,317,57266
2024-03-28,落马洲支线,出境,96646,14571,501,111718
2024-03-28,香园围,入境,23097,9149,121,32367
2024-03-28,香园围,出境,33024,3672,198,36894
2024-03-28,港珠澳大桥,入境,20804,6411,4722,31937
2024-03-28,港珠澳大桥,出境,63374,16479,4427,84280
2024-03-28,落马洲,入境,10629,2033,342,13004
2024-03-28,落马洲,出境,16494,3807,448,20749
2024-03-28,文锦渡,入境,901,390,9,1300
2024-03-28,文锦渡,出境,1634,391,10,2035
2024-03-28,沙头角,入境,0,0,0,0
2024-03-28,沙头角,出境,0,0,0,0
2024-03-28,深圳湾,入境,24154,8390,893,33437
2024-03-28,深圳湾,出境,61747,10748,1202,73697
2024-03-28,中国客运码头,入境,695,655,224,1574
2024-03-28,中国客运码头,出境,3017,806,321,4144
2024-03-28,港口管制,入境,0,0,86,86
2024-03-28,港口管制,出境,2,7,71,80
2024-03-28,启德邮轮码头,入境,0,0,1,1
2024-03-28,启德邮轮码头,出境,82,17,6039,6138
2024-03-28,港澳客轮码头,入境,5091,903,2446,8440
2024-03-28,港澳客轮码头,出境,9877,1401,2675,13953
2024-03-29,机场,入境,30510,10174,19962,60646
2024-03-29,机场,出境,66102,4561,13040,83703
2024-03-29,高铁西九龙,入境,12699,13111,1280,27090
2024-03-29,高铁西九龙,出境,59186,10274,1019,70479
2024-03-29,红磡,入境,0,0,0,0
2024-03-29,红磡,出境,0,0,0,0
2024-03-29,罗湖,入境,64837,9003,653,74493
2024-03-29,罗湖,出境,155071,12385,979,168435
2024-03-29,落马洲支线,入境,54882,10441,355,65678
2024-03-29,落马洲支线,出境,144020,11628,451,156099
2024-03-29,香园围,入境,22995,5013,136,28144
2024-03-29,香园围,出境,48258,3219,138,51615
2024-03-29,港珠澳大桥,入境,28981,6642,6891,42514
2024-03-29,港珠澳大桥,出境,88084,13344,5443,106871
2024-03-29,落马洲,入境,15718,1705,452,17875
2024-03-29,落马洲,出境,28580,3195,472,32247
2024-03-29,文锦渡,入境,953,290,24,1267
2024-03-29,文锦渡,出境,3492,391,6,3889
2024-03-29,沙头角,入境,0,0,0,0
2024-03-29,沙头角,出境,0,0,0,0
2024-03-29,深圳湾,入境,28319,7757,1131,37207
2024-03-29,深圳湾,出境,85269,7736,899,93904
2024-03-29,中国客运码头,入境,785,667,318,1770
2024-03-29,中国客运码头,出境,6052,825,299,7176
2024-03-29,港口管制,入境,0,0,13,13
2024-03-29,港口管制,出境,37,0,26,63
2024-03-29,启德邮轮码头,入境,938,865,88,1891
2024-03-29,启德邮轮码头,出境,1917,64,62,2043
2024-03-29,港澳客轮码头,入境,7549,1058,3023,11630
2024-03-29,港澳客轮码头,出境,14740,1322,3024,19086
2024-03-30,机场,入境,33871,9782,16986,60639
2024-03-30,机场,出境,44713,6277,18866,69856
2024-03-30,高铁西九龙,入境,21887,27361,1687,50935
2024-03-30,高铁西九龙,出境,43605,19028,1222,63855
2024-03-30,红磡,入境,0,0,0,0
2024-03-30,红磡,出境,0,0,0,0
2024-03-30,罗湖,入境,81402,14501,768,96671
2024-03-30,罗湖,出境,96339,17641,767,114747
2024-03-30,落马洲支线,入境,72112,20560,507,93179
2024-03-30,落马洲支线,出境,89142,18484,406,108032
2024-03-30,香园围,入境,29728,7131,219,37078
2024-03-30,香园围,出境,35643,4164,121,39928
2024-03-30,港珠澳大桥,入境,44088,7783,5564,57435
2024-03-30,港珠澳大桥,出境,54840,10908,5178,70926
2024-03-30,落马洲,入境,20572,2452,537,23561
2024-03-30,落马洲,出境,18485,5521,373,24379
2024-03-30,文锦渡,入境,921,467,22,1410
2024-03-30,文锦渡,出境,1636,339,7,1982
2024-03-30,沙头角,入境,0,0,0,0
2024-03-30,沙头角,出境,0,0,0,0
2024-03-30,深圳湾,入境,41174,13238,1256,55668
2024-03-30,深圳湾,出境,55258,12184,979,68421
2024-03-30,中国客运码头,入境,1471,963,296,2730
2024-03-30,中国客运码头,出境,3339,703,319,4361
2024-03-30,港口管制,入境,92,0,21,113
2024-03-30,港口管制,出境,1,0,16,17
2024-03-30,启德邮轮码头,入境,0,0,0,0
2024-03-30,启德邮轮码头,出境,0,0,0,0
2024-03-30,港澳客轮码头,入境,10415,1012,2938,14365
2024-03-30,港澳客轮码头,出境,10945,1496,3329,15770
2024-03-31,机场,入境,39636,7594,12871,60101
2024-03-31,机场,出境,37043,8700,24198,69941
2024-03-31,高铁西九龙,入境,35762,12919,1252,49933
2024-03-31,高铁西九龙,出境,29214,19924,1434,50572
2024-03-31,红磡,入境,0,0,0,0
2024-03-31,红磡,出境,0,0,0,0
2024-03-31,罗湖,入境,117397,10297,783,128477
2024-03-31,罗湖,出境,72118,14619,732,87469
2024-03-31,落马洲支线,入境,101628,12752,406,114786
2024-03-31,落马洲支线,出境,73384,14391,415,88190
2024-03-31,香园围,入境,37505,6402,142,44049
2024-03-31,香园围,出境,30112,3522,109,33743
2024-03-31,港珠澳大桥,入境,66078,6789,5254,78121
2024-03-31,港珠澳大桥,出境,46307,9490,5646,61443
2024-03-31,落马洲,入境,26838,1786,335,28959
2024-03-31,落马洲,出境,14255,4944,377,19576
2024-03-31,文锦渡,入境,1350,313,4,1667
2024-03-31,文锦渡,出境,959,293,4,1256
2024-03-31,沙头角,入境,0,0,0,0
2024-03-31,沙头角,出境,0,0,0,0
2024-03-31,深圳湾,入境,71658,7921,1109,80688
2024-03-31,深圳湾,出境,40304,11437,907,52648
2024-03-31,中国客运码头,入境,3931,558,224,4713
2024-03-31,中国客运码头,出境,1781,843,255,2879
2024-03-31,港口管制,入境,13,0,53,66
2024-03-31,港口管制,出境,33,0,40,73
2024-03-31,启德邮轮码头,入境,1916,64,35,2015
2024-03-31,启德邮轮码头,出境,1982,37,289,2308
2024-03-31,港澳客轮码头,入境,11886,879,2403,15168
2024-03-31,港澳客轮码头,出境,10808,1216,2951,14975
2024-04-01,机场,入境,58645,4580,10964,74189
2024-04-01,机场,出境,37721,6908,19178,63807
2024-04-01,高铁西九龙,入境,49500,8301,958,58759
2024-04-01,高铁西九龙,出境,23090,9001,1136,33227
2024-04-01,红磡,入境,0,0,0,0
2024-04-01,红磡,出境,0,0,0,0
2024-04-01,罗湖,入境,104089,8716,709,113514
2024-04-01,罗湖,出境,50744,8256,517,59517
2024-04-01,落马洲支线,入境,90011,8667,360,99038
2024-04-01,落马洲支线,出境,43779,6964,259,51002
2024-04-01,香园围,入境,31678,3903,85,35666
2024-04-01,香园围,出境,17660,1892,79,19631
2024-04-01,港珠澳大桥,入境,77767,5992,3939,87698
2024-04-01,港珠澳大桥,出境,29625,8765,4398,42788
2024-04-01,落马洲,入境,28177,1826,286,30289
2024-04-01,落马洲,出境,9536,2103,298,11937
2024-04-01,文锦渡,入境,2078,270,10,2358
2024-04-01,文锦渡,出境,885,183,8,1076
2024-04-01,沙头角,入境,0,0,0,0
2024-04-01,沙头角,出境,0,0,0,0
2024-04-01,深圳湾,入境,65916,6205,1071,73192
2024-04-01,深圳湾,出境,25389,5599,761,31749
2024-04-01,中国客运码头,入境,4977,540,205,5722
2024-04-01,中国客运码头,出境,1299,482,214,1995
2024-04-01,港口管制,入境,6,0,50,56
2024-04-01,港口管制,出境,0,0,72,72
2024-04-01,启德邮轮码头,入境,0,0,0,0
2024-04-01,启德邮轮码头,出境,0,0,0,0
2024-04-01,港澳客轮码头,入境,14829,699,1785,17313
2024-04-01,港澳客轮码头,出境,6641,1245,2377,10263
2024-04-02,机场,入境,47976,5554,12353,65883
2024-04-02,机场,出境,32357,6541,14974,53872
2024-04-02,高铁西九龙,入境,30782,11220,1274,43276
2024-04-02,高铁西九龙,出境,23090,9782,1150,34022
2024-04-02,红磡,入境,0,0,0,0
2024-04-02,红磡,出境,0,0,0,0
2024-04-02,罗湖,入境,69603,9244,772,79619
2024-04-02,罗湖,出境,63472,10258,638,74368
2024-04-02,落马洲支线,入境,57271,9676,471,67418
2024-04-02,落马洲支线,出境,51252,8919,391,60562
2024-04-02,香园围,入境,24961,3449,109,28519
2024-04-02,香园围,出境,23328,2189,96,25613
2024-04-02,港珠澳大桥,入境,36720,5653,3393,45766
2024-04-02,港珠澳大桥,出境,27122,7717,3188,38027
2024-04-02,落马洲,入境,15419,2171,345,17935
2024-04-02,落马洲,出境,8891,2437,302,11630
2024-04-02,文锦渡,入境,1041,279,11,1331
2024-04-02,文锦渡,出境,937,224,15,1176
2024-04-02,沙头角,入境,0,0,0,0
2024-04-02,沙头角,出境,0,0,0,0
2024-04-02,深圳湾,入境,34847,7434,1176,43457
2024-04-02,深圳湾,出境,28752,6626,921,36299
2024-04-02,中国客运码头,入境,1519,575,252,2346
2024-04-02,中国客运码头,出境,1284,675,233,2192
2024-04-02,港口管制,入境,2,0,38,40
2024-04-02,港口管制,出境,2,5,16,23
2024-04-02,启德邮轮码头,入境,2,0,1997,1999
2024-04-02,启德邮轮码头,出境,2,0,2,4
2024-04-02,港澳客轮码头,入境,7559,998,1975,10532
2024-04-02,港澳客轮码头,出境,6115,1467,2235,9817
2024-04-03,机场,入境,43105,8631,16703,68439
2024-04-03,机场,出境,32019,8110,12737,52866
2024-04-03,高铁西九龙,入境,18714,14331,1276,34321
2024-04-03,高铁西九龙,出境,28283,8406,987,37676
2024-04-03,红磡,入境,0,0,0,0
2024-04-03,红磡,出境,0,0,0,0
2024-04-03,罗湖,入境,64200,10434,760,75394
2024-04-03,罗湖,出境,90071,9790,751,100612
2024-04-03,落马洲支线,入境,51660,10607,471,62738
2024-04-03,落马洲支线,出境,61218,8557,328,70103
2024-04-03,香园围,入境,23279,3912,158,27349
2024-04-03,香园围,出境,26047,1959,132,28138
2024-04-03,港珠澳大桥,入境,30169,5731,3717,39617
2024-04-03,港珠澳大桥,出境,35540,7452,3318,46310
2024-04-03,落马洲,入境,12656,2391,458,15505
2024-04-03,落马洲,出境,11987,2154,313,14454
2024-04-03,文锦渡,入境,898,299,17,1214
2024-04-03,文锦渡,出境,1212,233,8,1453
2024-04-03,沙头角,入境,0,0,0,0
2024-04-03,沙头角,出境,0,0,0,0
2024-04-03,深圳湾,入境,32055,9297,1337,42689
2024-04-03,深圳湾,出境,44808,6363,930,52101
2024-04-03,中国客运码头,入境,1427,723,276,2426
2024-04-03,中国客运码头,出境,2719,755,270,3744
2024-04-03,港口管制,入境,2,0,51,53
2024-04-03,港口管制,出境,0,0,10,10
2024-04-03,启德邮轮码头,入境,1,0,297,298
2024-04-03,启德邮轮码头,出境,0,0,2015,2015
2024-04-03,港澳客轮码头,入境,6542,976,1935,9453
2024-04-03,港澳客轮码头,出境,7076,1521,2353,10950
2024-04-04,机场,入境,46441,7401,19136,72978
2024-04-04,机场,出境,29650,6230,11588,47468
2024-04-04,高铁西九龙,入境,31517,39096,1553,72166
2024-04-04,高铁西九龙,出境,19487,20208,923,40618
2024-04-04,红磡,入境,0,0,0,0
2024-04-04,红磡,出境,0,0,0,0
2024-04-04,罗湖,入境,96225,26583,804,123612
2024-04-04,罗湖,出境,63419,24754,746,88919
2024-04-04,落马洲支线,入境,74594,35544,567,110705
2024-04-04,落马洲支线,出境,55131,24860,354,80345
2024-04-04,香园围,入境,30784,8626,140,39550
2024-04-04,香园围,出境,25778,3839,218,29835
2024-04-04,港珠澳大桥,入境,47485,8876,5109,61470
2024-04-04,港珠澳大桥,出境,34224,10022,4816,49062
2024-04-04,落马洲,入境,21413,4208,365,25986
2024-04-04,落马洲,出境,12273,3612,229,16114
2024-04-04,文锦渡,入境,1375,772,19,2166
2024-04-04,文锦渡,出境,1181,336,5,1522
2024-04-04,沙头角,入境,0,0,0,0
2024-04-04,沙头角,出境,0,0,0,0
2024-04-04,深圳湾,入境,52201,20163,1253,73617
2024-04-04,深圳湾,出境,35517,11843,794,48154
2024-04-04,中国客运码头,入境,1928,2119,288,4335
2024-04-04,中国客运码头,出境,1855,841,232,2928
2024-04-04,港口管制,入境,0,0,29,29
2024-04-04,港口管制,出境,0,0,59,59
2024-04-04,启德邮轮码头,入境,0,0,0,0
2024-04-04,启德邮轮码头,出境,0,3,306,309
2024-04-04,港澳客轮码头,入境,8619,1427,2297,12343
2024-04-04,港澳客轮码头,出境,6344,1894,2285,10523
2024-04-05,机场,入境,48391,6316,18672,73379
2024-04-05,机场,出境,23459,6826,12462,42747
2024-04-05,高铁西九龙,入境,31143,30378,1520,63041
2024-04-05,高铁西九龙,出境,16171,26197,1172,43540
2024-04-05,红磡,入境,0,0,0,0
2024-04-05,红磡,出境,0,0,0,0
2024-04-05,罗湖,入境,77133,24973,848,102954
2024-04-05,罗湖,出境,60590,36026,953,97569
2024-04-05,落马洲支线,入境,55669,34478,659,90806
2024-04-05,落马洲支线,出境,51403,35349,653,87405
2024-04-05,香园围,入境,24861,7293,148,32302
2024-04-05,香园围,出境,23187,4696,159,28042
2024-04-05,港珠澳大桥,入境,33555,10119,4362,48036
2024-04-05,港珠澳大桥,出境,29026,12094,3671,44791
2024-04-05,落马洲,入境,15029,3689,331,19049
2024-04-05,落马洲,出境,9193,5604,326,15123
2024-04-05,文锦渡,入境,1030,815,16,1861
2024-04-05,文锦渡,出境,1035,573,10,1618
2024-04-05,沙头角,入境,0,0,0,0
2024-04-05,沙头角,出境,0,0,0,0
2024-04-05,深圳湾,入境,38925,19698,1276,59899
2024-04-05,深圳湾,出境,30849,19691,1089,51629
2024-04-05,中国客运码头,入境,1959,2018,353,4330
2024-04-05,中国客运码头,出境,1482,1499,308,3289
2024-04-05,港口管制,入境,1,0,58,59
2024-04-05,港口管制,出境,0,0,24,24
2024-04-05,启德邮轮码头,入境,1981,38,615,2634
2024-04-05,启德邮轮码头,出境,1812,88,65,1965
2024-04-05,港澳客轮码头,入境,5730,1961,2703,10394
2024-04-05,港澳客轮码头,出境,6114,2728,2737,11579
2024-04-06,机场,入境,54283,5669,16331,76283
2024-04-06,机场,出境,25130,10400,15494,51024
2024-04-06,高铁西九龙,入境,30313,14334,1112,45759
2024-04-06,高铁西九龙,出境,18486,28661,1553,48700
2024-04-06,红磡,入境,0,0,0,0
2024-04-06,红磡,出境,0,0,0,0
2024-04-06,罗湖,入境,76949,10384,734,88067
2024-04-06,罗湖,出境,72618,16207,784,89609
2024-04-06,落马洲支线,入境,57572,11785,383,69740
2024-04-06,落马洲支线,出境,61631,14879,421,76931
2024-04-06,香园围,入境,26179,4361,108,30648
2024-04-06,香园围,出境,26900,3202,153,30255
2024-04-06,港珠澳大桥,入境,37012,6334,5531,48877
2024-04-06,港珠澳大桥,出境,37914,8106,4980,51000
2024-04-06,落马洲,入境,16148,1732,299,18179
2024-04-06,落马洲,出境,12702,4247,380,17329
2024-04-06,文锦渡,入境,917,257,11,1185
2024-04-06,文锦渡,出境,1112,248,10,1370
2024-04-06,沙头角,入境,0,0,0,0
2024-04-06,沙头角,出境,0,0,0,0
2024-04-06,深圳湾,入境,40344,8751,987,50082
2024-04-06,深圳湾,出境,33730,13032,1346,48108
2024-04-06,中国客运码头,入境,2040,729,338,3107
2024-04-06,中国客运码头,出境,1570,1532,338,3440
2024-04-06,港口管制,入境,54,9,66,129
2024-04-06,港口管制,出境,0,2,32,34
2024-04-06,启德邮轮码头,入境,0,0,0,0
2024-04-06,启德邮轮码头,出境,0,0,0,0
2024-04-06,港澳客轮码头,入境,5755,1026,2479,9260
2024-04-06,港澳客轮码头,出境,7443,1455,2537,11435
2024-04-07,机场,入境,62471,5423,13472,81366
2024-04-07,机场,出境,27134,8729,21963,57826
2024-04-07,高铁西九龙,入境,42947,10029,1023,53999
2024-04-07,高铁西九龙,出境,10563,10584,1576,22723
2024-04-07,红磡,入境,0,0,0,0
2024-04-07,红磡,出境,0,0,0,0
2024-04-07,罗湖,入境,104365,10352,649,115366
2024-04-07,罗湖,出境,56942,9475,588,67005
2024-04-07,落马洲支线,入境,80353,10865,373,91591
2024-04-07,落马洲支线,出境,47937,8461,373,56771
2024-04-07,香园围,入境,35186,5339,133,40658
2024-04-07,香园围,出境,25037,2449,106,27592
2024-04-07,港珠澳大桥,入境,51741,6370,4884,62995
2024-04-07,港珠澳大桥,出境,20579,6005,5009,31593
2024-04-07,落马洲,入境,23710,1896,273,25879
2024-04-07,落马洲,出境,10524,2322,607,13453
2024-04-07,文锦渡,入境,1626,278,9,1913
2024-04-07,文锦渡,出境,952,227,10,1189
2024-04-07,沙头角,入境,0,0,0,0
2024-04-07,沙头角,出境,0,0,0,0
2024-04-07,深圳湾,入境,62517,8311,869,71697
2024-04-07,深圳湾,出境,26666,6565,1326,34557
2024-04-07,中国客运码头,入境,2966,701,209,3876
2024-04-07,中国客运码头,出境,728,692,340,1760
2024-04-07,港口管制,入境,0,0,60,60
2024-04-07,港口管制,出境,3,1,15,19
2024-04-07,启德邮轮码头,入境,1816,88,593,2497
2024-04-07,启德邮轮码头,出境,2,1,380,383
2024-04-07,港澳客轮码头,入境,8722,661,2058,11441
2024-04-07,港澳客轮码头,出境,4515,755,2759,8029
2024-04-08,机场,入境,44718,8591,17244,70553
2024-04-08,机场,出境,26524,6073,18675,51272
2024-04-08,高铁西九龙,入境,23228,12956,1270,37454
2024-04-08,高铁西九龙,出境,12617,9422,1553,23592
2024-04-08,红磡,入境,0,0,0,0
2024-04-08,红磡,出境,0,0,0,0
2024-04-08,罗湖,入境,65784,11459,770,78013
2024-04-08,罗湖,出境,56048,10684,901,67633
2024-04-08,落马洲支线,入境,52578,10857,386,63821
2024-04-08,落马洲支线,出境,47614,9131,458,57203
2024-04-08,香园围,入境,24038,6772,135,30945
2024-04-08,香园围,出境,23473,2250,210,25933
2024-04-08,港珠澳大桥,入境,21598,5617,3909,31124
2024-04-08,港珠澳大桥,出境,17378,7719,3385,28482
2024-04-08,落马洲,入境,12653,2961,267,15881
2024-04-08,落马洲,出境,8637,2903,770,12310
2024-04-08,文锦渡,入境,1457,333,12,1802
2024-04-08,文锦渡,出境,1402,267,21,1690
2024-04-08,沙头角,入境,0,0,0,0
2024-04-08,沙头角,出境,0,0,0,0
2024-04-08,深圳湾,入境,31889,8742,1011,41642
2024-04-08,深圳湾,出境,25115,7464,1643,34222
2024-04-08,中国客运码头,入境,1135,683,337,2155
2024-04-08,中国客运码头,出境,779,695,409,1883
2024-04-08,港口管制,入境,14,5,125,144
2024-04-08,港口管制,出境,1,2,51,54
2024-04-08,启德邮轮码头,入境,6,1,883,890
2024-04-08,启德邮轮码头,出境,4,1,613,618
2024-04-08,港澳客轮码头,入境,5326,588,2087,8001
2024-04-08,港澳客轮码头,出境,4496,793,2694,7983
2024-04-09,机场,入境,32110,7917,18985,59012
2024-04-09,机场,出境,22984,6957,15809,45750
2024-04-09,高铁西九龙,入境,14861,11741,1177,27779
2024-04-09,高铁西九龙,出境,11511,10620,1434,23565
2024-04-09,红磡,入境,0,0,0,0
2024-04-09,红磡,出境,0,0,0,0
2024-04-09,罗湖,入境,58697,10328,630,69655
2024-04-09,罗湖,出境,55690,10699,858,67247
2024-04-09,落马洲支线,入境,47850,10725,315,58890
2024-04-09,落马洲支线,出境,47396,10265,443,58104
2024-04-09,香园围,入境,23496,10175,128,33799
2024-04-09,香园围,出境,23761,2888,347,26996
2024-04-09,港珠澳大桥,入境,17645,5962,3585,27192
2024-04-09,港珠澳大桥,出境,16632,9803,3493,29928
2024-04-09,落马洲,入境,9728,2135,250,12113
2024-04-09,落马洲,出境,8182,2865,614,11661
2024-04-09,文锦渡,入境,1360,379,10,1749
2024-04-09,文锦渡,出境,1432,304,6,1742
2024-04-09,沙头角,入境,0,0,0,0
2024-04-09,沙头角,出境,0,0,0,0
2024-04-09,深圳湾,入境,25748,8790,995,35533
2024-04-09,深圳湾,出境,23740,8452,1525,33717
2024-04-09,中国客运码头,入境,773,651,237,1661
2024-04-09,中国客运码头,出境,618,1184,251,2053
2024-04-09,港口管制,入境,8,0,17,25
2024-04-09,港口管制,出境,3,0,12,15
2024-04-09,启德邮轮码头,入境,0,0,0,0
2024-04-09,启德邮轮码头,出境,0,0,0,0
2024-04-09,港澳客轮码头,入境,4561,655,2317,7533
2024-04-09,港澳客轮码头,出境,4202,952,2399,7553
2024-04-10,机场,入境,25687,8459,23434,57580
2024-04-10,机场,出境,25089,7929,19210,52228
2024-04-10,高铁西九龙,入境,12866,15118,1423,29407
2024-04-10,高铁西九龙,出境,12273,11228,1494,24995
2024-04-10,红磡,入境,0,0,0,0
2024-04-10,红磡,出境,0,0,0,0
2024-04-10,罗湖,入境,59561,11275,672,71508
2024-04-10,罗湖,出境,57925,11753,832,70510
2024-04-10,落马洲支线,入境,48567,11901,364,60832
2024-04-10,落马洲支线,出境,49313,10854,392,60559
2024-04-10,香园围,入境,24244,11373,182,35799
2024-04-10,香园围,出境,25237,3156,290,28683
2024-04-10,港珠澳大桥,入境,16450,6664,3844,26958
2024-04-10,港珠澳大桥,出境,16694,13957,4205,34856
2024-04-10,落马洲,入境,10099,3373,366,13838
2024-04-10,落马洲,出境,8505,2836,498,11839
2024-04-10,文锦渡,入境,1403,407,30,1840
2024-04-10,文锦渡,出境,1515,289,16,1820
2024-04-10,沙头角,入境,0,0,0,0
2024-04-10,沙头角,出境,0,0,0,0
2024-04-10,深圳湾,入境,25693,12496,1037,39226
2024-04-10,深圳湾,出境,25124,7953,1280,34357
2024-04-10,中国客运码头,入境,677,531,271,1479
2024-04-10,中国客运码头,出境,699,571,252,1522
2024-04-10,港口管制,入境,0,0,102,102
2024-04-10,港口管制,出境,0,0,49,49
2024-04-10,启德邮轮码头,入境,8,0,2610,2618
2024-04-10,启德邮轮码头,出境,0,1,943,944
2024-04-10,港澳客轮码头,入境,4503,796,2180,7479
2024-04-10,港澳客轮码头,出境,4151,1223,2427,7801
2024-04-11,机场,入境,21885,8292,21324,51501
2024-04-11,机场,出境,27124,7258,15079,49461
2024-04-11,高铁西九龙,入境,12205,20400,1690,34295
2024-04-11,高铁西九龙,出境,13028,13050,1647,27725
2024-04-11,红磡,入境,0,0,0,0
2024-04-11,红磡,出境,0,0,0,0
2024-04-11,罗湖,入境,57349,11072,805,69226
2024-04-11,罗湖,出境,56593,11856,893,69342
2024-04-11,落马洲支线,入境,47937,12645,404,60986
2024-04-11,落马洲支线,出境,49247,11842,402,61491
2024-04-11,香园围,入境,24980,11894,175,37049
2024-04-11,香园围,出境,26036,3375,267,29678
2024-04-11,港珠澳大桥,入境,16894,7111,3750,27755
2024-04-11,港珠澳大桥,出境,18014,16414,4254,38682
2024-04-11,落马洲,入境,9654,2957,473,13084
2024-04-11,落马洲,出境,8853,3133,552,12538
2024-04-11,文锦渡,入境,1433,359,15,1807
2024-04-11,文锦渡,出境,1472,308,6,1786
2024-04-11,沙头角,入境,0,0,0,0
2024-04-11,沙头角,出境,0,0,0,0
2024-04-11,深圳湾,入境,25311,10731,1384,37426
2024-04-11,深圳湾,出境,26800,8597,1265,36662
2024-04-11,中国客运码头,入境,623,624,431,1678
2024-04-11,中国客运码头,出境,813,611,341,1765
2024-04-11,港口管制,入境,0,0,44,44
2024-04-11,港口管制,出境,90,0,21,111
2024-04-11,启德邮轮码头,入境,0,0,0,0
2024-04-11,启德邮轮码头,出境,12,0,2537,2549
2024-04-11,港澳客轮码头,入境,4331,800,2987,8118
2024-04-11,港澳客轮码头,出境,4429,1334,2925,8688
2024-04-12,机场,入境,24613,8552,24389,57554
2024-04-12,机场,出境,30705,8177,17066,55948
2024-04-12,高铁西九龙,入境,14279,20463,1860,36602
2024-04-12,高铁西九龙,出境,22102,16065,1698,39865
2024-04-12,红磡,入境,0,0,0,0
2024-04-12,红磡,出境,0,0,0,0
2024-04-12,罗湖,入境,61125,13295,939,75359
2024-04-12,罗湖,出境,73139,15971,1085,90195
2024-04-12,落马洲支线,入境,50237,14570,493,65300
2024-04-12,落马洲支线,出境,62075,14380,428,76883
2024-04-12,香园围,入境,25476,9654,198,35328
2024-04-12,香园围,出境,29280,4939,225,34444
2024-04-12,港珠澳大桥,入境,18498,8841,4716,32055
2024-04-12,港珠澳大桥,出境,28271,17293,4155,49719
2024-04-12,落马洲,入境,11571,3620,615,15806
2024-04-12,落马洲,出境,11469,3734,445,15648
2024-04-12,文锦渡,入境,1408,400,9,1817
2024-04-12,文锦渡,出境,1752,349,6,2107
2024-04-12,沙头角,入境,0,0,0,0
2024-04-12,沙头角,出境,0,0,0,0
2024-04-12,深圳湾,入境,28235,13548,1620,43403
2024-04-12,深圳湾,出境,41812,10598,1306,53716
2024-04-12,中国客运码头,入境,866,845,388,2099
2024-04-12,中国客运码头,出境,1759,664,425,2848
2024-04-12,港口管制,入境,6,0,79,85
2024-04-12,港口管制,出境,7,0,74,81
2024-04-12,启德邮轮码头,入境,2,0,36,38
2024-04-12,启德邮轮码头,出境,1308,413,120,1841
2024-04-12,港澳客轮码头,入境,4985,1090,3960,10035
2024-04-12,港澳客轮码头,出境,5586,1603,3502,10691
2024-04-13,机场,入境,25872,7678,22337,55887
2024-04-13,机场,出境,27410,7004,19832,54246
2024-04-13,高铁西九龙,入境,15403,29596,1775,46774
2024-04-13,高铁西九龙,出境,23849,23975,1853,49677
2024-04-13,红磡,入境,0,0,0,0
2024-04-13,红磡,出境,0,0,0,0
2024-04-13,罗湖,入境,77186,20634,1013,98833
2024-04-13,罗湖,出境,102340,25947,1263,129550
2024-04-13,落马洲支线,入境,64781,28696,555,94032
2024-04-13,落马洲支线,出境,91068,27705,621,119394
2024-04-13,香园围,入境,31650,12219,201,44070
2024-04-13,香园围,出境,41130,6053,211,47394
2024-04-13,港珠澳大桥,入境,24251,9571,6470,40292
2024-04-13,港珠澳大桥,出境,41874,15691,5217,62782
2024-04-13,落马洲,入境,16525,3716,522,20763
2024-04-13,落马洲,出境,16649,5544,544,22737
2024-04-13,文锦渡,入境,1051,604,13,1668
2024-04-13,文锦渡,出境,1720,469,4,2193
2024-04-13,沙头角,入境,0,0,0,0
2024-04-13,沙头角,出境,0,0,0,0
2024-04-13,深圳湾,入境,36004,19055,1370,56429
2024-04-13,深圳湾,出境,53679,16529,1688,71896
2024-04-13,中国客运码头,入境,874,1203,396,2473
2024-04-13,中国客运码头,出境,2483,894,394,3771
2024-04-13,港口管制,入境,0,0,27,27
2024-04-13,港口管制,出境,2,0,37,39
2024-04-13,启德邮轮码头,入境,0,0,0,0
2024-04-13,启德邮轮码头,出境,0,0,0,0
2024-04-13,港澳客轮码头,入境,5157,1226,3256,9639
2024-04-13,港澳客轮码头,出境,7533,1634,3377,12544
2024-04-14,机场,入境,33511,8269,18926,60706
2024-04-14,机场,出境,26569,9088,24260,59917
2024-04-14,高铁西九龙,入境,26558,17585,1551,45694
2024-04-14,高铁西九龙,出境,12627,25343,4659,42629
2024-04-14,红磡,入境,0,0,0,0
2024-04-14,红磡,出境,0,0,0,0
2024-04-14,罗湖,入境,106561,15034,934,122529
2024-04-14,罗湖,出境,68976,19705,1239,89920
2024-04-14,落马洲支线,入境,84462,18542,489,103493
2024-04-14,落马洲支线,出境,61641,19523,638,81802
2024-04-14,香园围,入境,41368,13169,352,54889
2024-04-14,香园围,出境,33430,5508,196,39134
2024-04-14,港珠澳大桥,入境,46697,8282,6580,61559
2024-04-14,港珠澳大桥,出境,24240,12494,6174,42908
2024-04-14,落马洲,入境,26093,2521,389,29003
2024-04-14,落马洲,出境,12313,6280,973,19566
2024-04-14,文锦渡,入境,1495,504,21,2020
2024-04-14,文锦渡,出境,1164,484,10,1658
2024-04-14,沙头角,入境,0,0,0,0
2024-04-14,沙头角,出境,0,0,0,0
2024-04-14,深圳湾,入境,61882,11642,1164,74688
2024-04-14,深圳湾,出境,35088,16510,2804,54402
2024-04-14,中国客运码头,入境,2507,715,330,3552
2024-04-14,中国客运码头,出境,1149,865,563,2577
2024-04-14,港口管制,入境,7,0,64,71
2024-04-14,港口管制,出境,25,0,28,53
2024-04-14,启德邮轮码头,入境,1319,414,387,2120
2024-04-14,启德邮轮码头,出境,644,1210,205,2059
2024-04-14,港澳客轮码头,入境,8181,925,2574,11680
2024-04-14,港澳客轮码头,出境,4773,1078,2987,8838
2024-04-15,机场,入境,28028,9672,19068,56768
2024-04-15,机场,出境,24927,7400,21336,53663
2024-04-15,高铁西九龙,入境,15652,14261,1441,31354
2024-04-15,高铁西九龙,出境,12705,12819,3973,29497
2024-04-15,红磡,入境,0,0,0,0
2024-04-15,红磡,出境,0,0,0,0
2024-04-15,罗湖,入境,64775,12385,870,78030
2024-04-15,罗湖,出境,58672,12024,1144,71840
2024-04-15,落马洲支线,入境,52024,11731,408,64163
2024-04-15,落马洲支线,出境,50222,10695,559,61476
2024-04-15,香园围,入境,25235,11293,142,36670
2024-04-15,香园围,出境,24994,3114,276,28384
2024-04-15,港珠澳大桥,入境,22900,6924,4240,34064
2024-04-15,港珠澳大桥,出境,17223,13446,4150,34819
2024-04-15,落马洲,入境,12372,2797,330,15499
2024-04-15,落马洲,出境,8287,3717,1006,13010
2024-04-15,文锦渡,入境,1597,338,8,1943
2024-04-15,文锦渡,出境,1785,304,18,2107
2024-04-15,沙头角,入境,0,0,0,0
2024-04-15,沙头角,出境,0,0,0,0
2024-04-15,深圳湾,入境,32786,9472,1024,43282
2024-04-15,深圳湾,出境,24946,8591,2476,36013
2024-04-15,中国客运码头,入境,1422,654,219,2295
2024-04-15,中国客运码头,出境,832,608,415,1855
2024-04-15,港口管制,入境,0,0,21,21
2024-04-15,港口管制,出境,0,0,34,34
2024-04-15,启德邮轮码头,入境,0,0,0,0
2024-04-15,启德邮轮码头,出境,2,0,411,413
2024-04-15,港澳客轮码头,入境,5120,741,2448,8309
2024-04-15,港澳客轮码头,出境,4537,971,2636,8144
2024-04-16,机场,入境,23780,7929,15339,47048
2024-04-16,机场,出境,21813,6839,19983,48635
2024-04-16,高铁西九龙,入境,12168,12619,1435,26222
2024-04-16,高铁西九龙,出境,12002,13271,2649,27922
2024-04-16,红磡,入境,0,0,0,0
2024-04-16,红磡,出境,0,0,0,0
2024-04-16,罗湖,入境,58522,11532,795,70849
2024-04-16,罗湖,出境,57579,12749,977,71305
2024-04-16,落马洲支线,入境,48450,11600,422,60472
2024-04-16,落马洲支线,出境,49949,11768,491,62208
2024-04-16,香园围,入境,24247,9797,133,34177
2024-04-16,香园围,出境,25081,4160,179,29420
2024-04-16,港珠澳大桥,入境,17365,7261,3893,28519
2024-04-16,港珠澳大桥,出境,17308,15007,3466,35781
2024-04-16,落马洲,入境,9712,2267,416,12395
2024-04-16,落马洲,出境,8317,3362,703,12382
2024-04-16,文锦渡,入境,1468,324,18,1810
2024-04-16,文锦渡,出境,1603,302,16,1921
2024-04-16,沙头角,入境,0,0,0,0
2024-04-16,沙头角,出境,0,0,0,0
2024-04-16,深圳湾,入境,26818,8993,1034,36845
2024-04-16,深圳湾,出境,24257,9451,1638,35346
2024-04-16,中国客运码头,入境,658,630,230,1518
2024-04-16,中国客运码头,出境,604,812,281,1697
2024-04-16,港口管制,入境,0,0,76,76
2024-04-16,港口管制,出境,15,0,29,44
2024-04-16,启德邮轮码头,入境,0,0,0,0
2024-04-16,启德邮轮码头,出境,0,0,0,0
2024-04-16,港澳客轮码头,入境,4589,786,1918,7293
2024-04-16,港澳客轮码头,出境,4376,1168,2302,7846
2024-04-17,机场,入境,22885,8856,17246,48987
2024-04-17,机场,出境,24080,7262,18037,49379
2024-04-17,高铁西九龙,入境,12065,12632,2073,26770
2024-04-17,高铁西九龙,出境,12710,11243,1943,25896
2024-04-17,红磡,入境,0,0,0,0
2024-04-17,红磡,出境,0,0,0,0
2024-04-17,罗湖,入境,58404,10953,890,70247
2024-04-17,罗湖,出境,58106,11974,870,70950
2024-04-17,落马洲支线,入境,48006,11367,425,59798
2024-04-17,落马洲支线,出境,49764,10823,413,61000
2024-04-17,香园围,入境,23370,11197,213,34780
2024-04-17,香园围,出境,24548,3402,191,28141
2024-04-17,港珠澳大桥,入境,17029,6787,3858,27674
2024-04-17,港珠澳大桥,出境,16980,14934,3421,35335
2024-04-17,落马洲,入境,9833,2993,517,13343
2024-04-17,落马洲,出境,8217,2689,561,11467
2024-04-17,文锦渡,入境,1456,401,11,1868
2024-04-17,文锦渡,出境,1558,321,6,1885
2024-04-17,沙头角,入境,0,0,0,0
2024-04-17,沙头角,出境,0,0,0,0
2024-04-17,深圳湾,入境,25250,11561,1414,38225
2024-04-17,深圳湾,出境,24822,8206,1277,34305
2024-04-17,中国客运码头,入境,642,660,302,1604
2024-04-17,中国客运码头,出境,772,655,323,1750
2024-04-17,港口管制,入境,3,3,20,26
2024-04-17,港口管制,出境,10,2,20,32
2024-04-17,启德邮轮码头,入境,0,0,0,0
2024-04-17,启德邮轮码头,出境,0,0,0,0
2024-04-17,港澳客轮码头,入境,4540,987,2262,7789
2024-04-17,港澳客轮码头,出境,4168,1366,2535,8069
2024-04-18,机场,入境,22102,7866,18383,48351
2024-04-18,机场,出境,27932,6938,16693,51563
2024-04-18,高铁西九龙,入境,12764,15061,2809,30634
2024-04-18,高铁西九龙,出境,12682,12464,1632,26778
2024-04-18,红磡,入境,0,0,0,0
2024-04-18,红磡,出境,0,0,0,0
2024-04-18,罗湖,入境,57566,10449,840,68855
2024-04-18,罗湖,出境,56875,11776,808,69459
2024-04-18,落马洲支线,入境,46750,10974,479,58203
2024-04-18,落马洲支线,出境,48262,10872,430,59564
2024-04-18,香园围,入境,22963,8271,212,31446
2024-04-18,香园围,出境,24169,2861,203,27233
2024-04-18,港珠澳大桥,入境,17048,6492,3972,27512
2024-04-18,港珠澳大桥,出境,18118,13377,3668,35163
2024-04-18,落马洲,入境,9562,2645,650,12857
2024-04-18,落马洲,出境,8224,2917,409,11550
2024-04-18,文锦渡,入境,1432,314,17,1763
2024-04-18,文锦渡,出境,1491,256,12,1759
2024-04-18,沙头角,入境,0,0,0,0
2024-04-18,沙头角,出境,0,0,0,0
2024-04-18,深圳湾,入境,25153,10774,1872,37799
2024-04-18,深圳湾,出境,25457,9271,1197,35925
2024-04-18,中国客运码头,入境,758,647,227,1632
2024-04-18,中国客运码头,出境,810,712,257,1779
2024-04-18,港口管制,入境,0,0,14,14
2024-04-18,港口管制,出境,25,0,18,43
2024-04-18,启德邮轮码头,入境,0,0,0,0
2024-04-18,启德邮轮码头,出境,0,0,0,0
2024-04-18,港澳客轮码头,入境,4394,1015,1904,7313
2024-04-18,港澳客轮码头,出境,4577,1294,2000,7871
2024-04-19,机场,入境,24431,9038,19581,53050
2024-04-19,机场,出境,29837,8615,18450,56902
2024-04-19,高铁西九龙,入境,13620,17025,3450,34095
2024-04-19,高铁西九龙,出境,21984,13630,1539,37153
2024-04-19,红磡,入境,0,0,0,0
2024-04-19,红磡,出境,0,0,0,0
2024-04-19,罗湖,入境,59957,11758,1134,72849
2024-04-19,罗湖,出境,71671,13413,901,85985
2024-04-19,落马洲支线,入境,49905,12343,562,62810
2024-04-19,落马洲支线,出境,63144,12360,378,75882
2024-04-19,香园围,入境,24493,6769,255,31517
2024-04-19,香园围,出境,27965,3294,205,31464
2024-04-19,港珠澳大桥,入境,18463,6609,4170,29242
2024-04-19,港珠澳大桥,出境,28035,13339,3472,44846
2024-04-19,落马洲,入境,10644,2901,796,14341
2024-04-19,落马洲,出境,10990,3250,438,14678
2024-04-19,文锦渡,入境,1410,324,17,1751
2024-04-19,文锦渡,出境,1822,314,19,2155
2024-04-19,沙头角,入境,0,0,0,0
2024-04-19,沙头角,出境,0,0,0,0
2024-04-19,深圳湾,入境,26608,11524,2308,40440
2024-04-19,深圳湾,出境,36444,10460,1168,48072
2024-04-19,中国客运码头,入境,800,653,385,1838
2024-04-19,中国客运码头,出境,1549,722,273,2544
2024-04-19,港口管制,入境,34,29,57,120
2024-04-19,港口管制,出境,0,35,67,102
2024-04-19,启德邮轮码头,入境,673,1215,3715,5603
2024-04-19,启德邮轮码头,出境,1651,122,3607,5380
2024-04-19,港澳客轮码头,入境,5049,957,2548,8554
2024-04-19,港澳客轮码头,出境,5993,1260,2613,9866
2024-04-20,机场,入境,25359,8992,19300,53651
2024-04-20,机场,出境,26541,8302,19604,54447
2024-04-20,高铁西九龙,入境,14710,24783,2784,42277
2024-04-20,高铁西九龙,出境,24403,19540,1647,45590
2024-04-20,红磡,入境,0,0,0,0
2024-04-20,红磡,出境,0,0,0,0
2024-04-20,罗湖,入境,75381,16240,1049,92670
2024-04-20,罗湖,出境,100703,19885,930,121518
2024-04-20,落马洲支线,入境,64091,20499,565,85155
2024-04-20,落马洲支线,出境,89163,19679,476,109318
2024-04-20,香园围,入境,29446,10627,123,40196
2024-04-20,香园围,出境,39723,5698,130,45551
2024-04-20,港珠澳大桥,入境,22318,8506,5711,36535
2024-04-20,港珠澳大桥,出境,39927,12192,4573,56692
2024-04-20,落马洲,入境,15437,2892,676,19005
2024-04-20,落马洲,出境,16117,4451,574,21142
2024-04-20,文锦渡,入境,1001,580,15,1596
2024-04-20,文锦渡,出境,1602,406,9,2017
2024-04-20,沙头角,入境,0,0,0,0
2024-04-20,沙头角,出境,0,0,0,0
2024-04-20,深圳湾,入境,32749,15741,1976,50466
2024-04-20,深圳湾,出境,48942,14295,1432,64669
2024-04-20,中国客运码头,入境,777,813,373,1963
2024-04-20,中国客运码头,出境,1838,754,364,2956
2024-04-20,港口管制,入境,0,0,28,28
2024-04-20,港口管制,出境,1,0,52,53
2024-04-20,启德邮轮码头,入境,0,0,0,0
2024-04-20,启德邮轮码头,出境,0,0,0,0
2024-04-20,港澳客轮码头,入境,5006,984,2573,8563
2024-04-20,港澳客轮码头,出境,7286,1212,3024,11522
2024-04-21,机场,入境,31755,9339,17426,58520
2024-04-21,机场,出境,25715,10183,23607,59505
2024-04-21,高铁西九龙,入境,25948,11736,1744,39428
2024-04-21,高铁西九龙,出境,11729,18829,2468,33026
2024-04-21,红磡,入境,0,0,0,0
2024-04-21,红磡,出境,0,0,0,0
2024-04-21,罗湖,入境,94450,9972,928,105350
2024-04-21,罗湖,出境,57802,13829,882,72513
2024-04-21,落马洲支线,入境,73070,10467,363,83900
2024-04-21,落马洲支线,出境,50137,11598,442,62177
2024-04-21,香园围,入境,35088,11358,154,46600
2024-04-21,香园围,出境,24065,4633,177,28875
2024-04-21,港珠澳大桥,入境,44538,6688,4775,56001
2024-04-21,港珠澳大桥,出境,21345,10187,4903,36435
2024-04-21,落马洲,入境,22101,2211,477,24789
2024-04-21,落马洲,出境,9418,4370,765,14553
2024-04-21,文锦渡,入境,1264,223,6,1493
2024-04-21,文锦渡,出境,700,205,15,920
2024-04-21,沙头角,入境,0,0,0,0
2024-04-21,沙头角,出境,0,0,0,0
2024-04-21,深圳湾,入境,48917,8255,1401,58573
2024-04-21,深圳湾,出境,24638,12989,1704,39331
2024-04-21,中国客运码头,入境,1743,303,225,2271
2024-04-21,中国客运码头,出境,611,633,288,1532
2024-04-21,港口管制,入境,80,0,54,134
2024-04-21,港口管制,出境,2,0,35,37
2024-04-21,启德邮轮码头,入境,1616,115,1274,3005
2024-04-21,启德邮轮码头,出境,974,916,142,2032
2024-04-21,港澳客轮码头,入境,7539,705,1835,10079
2024-04-21,港澳客轮码头,出境,4355,941,2404,7700
2024-04-22,机场,入境,30620,9559,17399,57578
2024-04-22,机场,出境,24814,8502,18258,51574
2024-04-22,高铁西九龙,入境,14966,11035,1525,27526
2024-04-22,高铁西九龙,出境,11868,10070,3543,25481
2024-04-22,红磡,入境,0,0,0,0
2024-04-22,红磡,出境,0,0,0,0
2024-04-22,罗湖,入境,59735,10056,865,70656
2024-04-22,罗湖,出境,53027,10101,983,64111
2024-04-22,落马洲支线,入境,47996,9361,372,57729
2024-04-22,落马洲支线,出境,45998,8632,439,55069
2024-04-22,香园围,入境,20952,9446,141,30539
2024-04-22,香园围,出境,20614,2809,185,23608
2024-04-22,港珠澳大桥,入境,20021,5379,3820,29220
2024-04-22,港珠澳大桥,出境,15406,12113,3411,30930
2024-04-22,落马洲,入境,10833,2614,346,13793
2024-04-22,落马洲,出境,7659,2925,805,11389
2024-04-22,文锦渡,入境,1445,328,20,1793
2024-04-22,文锦渡,出境,1466,270,17,1753
2024-04-22,沙头角,入境,0,0,0,0
2024-04-22,沙头角,出境,0,0,0,0
2024-04-22,深圳湾,入境,27187,7482,1072,35741
2024-04-22,深圳湾,出境,22686,6947,2071,31704
2024-04-22,中国客运码头,入境,851,454,228,1533
2024-04-22,中国客运码头,出境,708,411,312,1431
2024-04-22,港口管制,入境,1,0,68,69
2024-04-22,港口管制,出境,0,0,59,59
2024-04-22,启德邮轮码头,入境,34,1573,2483,4090
2024-04-22,启德邮轮码头,出境,0,0,1220,1220
2024-04-22,港澳客轮码头,入境,4861,683,1935,7479
2024-04-22,港澳客轮码头,出境,3927,922,2336,7185
2024-04-23,机场,入境,23383,8651,13927,45961
2024-04-23,机场,出境,22920,7854,16893,47667
2024-04-23,高铁西九龙,入境,11364,9525,1533,22422
2024-04-23,高铁西九龙,出境,11457,9695,2337,23489
2024-04-23,红磡,入境,0,0,0,0
2024-04-23,红磡,出境,0,0,0,0
2024-04-23,罗湖,入境,47587,7992,702,56281
2024-04-23,罗湖,出境,47162,8724,772,56658
2024-04-23,落马洲支线,入境,39747,8346,354,48447
2024-04-23,落马洲支线,出境,40201,7867,320,48388
2024-04-23,香园围,入境,16150,7368,196,23714
2024-04-23,香园围,出境,15883,2743,244,18870
2024-04-23,港珠澳大桥,入境,14317,5516,3060,22893
2024-04-23,港珠澳大桥,出境,14057,11224,2754,28035
2024-04-23,落马洲,入境,8497,2382,377,11256
2024-04-23,落马洲,出境,7400,2096,551,10047
2024-04-23,文锦渡,入境,1285,214,3,1502
2024-04-23,文锦渡,出境,1413,191,10,1614
2024-04-23,沙头角,入境,0,0,0,0
2024-04-23,沙头角,出境,0,0,0,0
2024-04-23,深圳湾,入境,21011,6572,1091,28674
2024-04-23,深圳湾,出境,19077,6495,1392,26964
2024-04-23,中国客运码头,入境,587,431,259,1277
2024-04-23,中国客运码头,出境,591,476,309,1376
2024-04-23,港口管制,入境,0,0,20,20
2024-04-23,港口管制,出境,0,0,25,25
2024-04-23,启德邮轮码头,入境,0,0,0,0
2024-04-23,启德邮轮码头,出境,35,1739,2387,4161
2024-04-23,港澳客轮码头,入境,3756,596,1586,5938
2024-04-23,港澳客轮码头,出境,3561,913,1828,6302
2024-04-24,机场,入境,24418,8362,16794,49574
2024-04-24,机场,出境,24542,7653,18269,50464
2024-04-24,高铁西九龙,入境,11466,10300,2037,23803
2024-04-24,高铁西九龙,出境,12171,9661,1695,23527
2024-04-24,红磡,入境,0,0,0,0
2024-04-24,红磡,出境,0,0,0,0
2024-04-24,罗湖,入境,55419,9977,756,66152
2024-04-24,罗湖,出境,54783,10476,717,65976
2024-04-24,落马洲支线,入境,46434,10676,373,57483
2024-04-24,落马洲支线,出境,47872,10275,375,58522
2024-04-24,香园围,入境,21463,10556,137,32156
2024-04-24,香园围,出境,22166,3074,100,25340
2024-04-24,港珠澳大桥,入境,14899,5354,3905,24158
2024-04-24,港珠澳大桥,出境,16224,12440,3306,31970
2024-04-24,落马洲,入境,9130,2208,491,11829
2024-04-24,落马洲,出境,8066,2543,537,11146
2024-04-24,文锦渡,入境,1499,347,6,1852
2024-04-24,文锦渡,出境,1546,287,9,1842
2024-04-24,沙头角,入境,0,0,0,0
2024-04-24,沙头角,出境,0,0,0,0
2024-04-24,深圳湾,入境,23856,7431,1603,32890
2024-04-24,深圳湾,出境,23345,7118,1079,31542
2024-04-24,中国客运码头,入境,535,549,270,1354
2024-04-24,中国客运码头,出境,810,529,266,1605
2024-04-24,港口管制,入境,0,0,36,36
2024-04-24,港口管制,出境,0,3,35,38
2024-04-24,启德邮轮码头,入境,988,922,2669,4579
2024-04-24,启德邮轮码头,出境,1246,751,95,2092
2024-04-24,港澳客轮码头,入境,4019,818,1900,6737
2024-04-24,港澳客轮码头,出境,4030,1116,2237,7383
2024-04-25,机场,入境,23523,8170,16320,48013
2024-04-25,机场,出境,27360,7649,16138,51147
2024-04-25,高铁西九龙,入境,11940,10918,2550,25408
2024-04-25,高铁西九龙,出境,13378,9510,1471,24359
2024-04-25,红磡,入境,0,0,0,0
2024-04-25,红磡,出境,0,0,0,0
2024-04-25,罗湖,入境,53452,8772,766,62990
2024-04-25,罗湖,出境,54120,9634,733,64487
2024-04-25,落马洲支线,入境,44409,9228,408,54045
2024-04-25,落马洲支线,出境,46212,9154,350,55716
2024-04-25,香园围,入境,20160,7440,251,27851
2024-04-25,香园围,出境,21348,2413,106,23867
2024-04-25,港珠澳大桥,入境,15920,5413,3548,24881
2024-04-25,港珠澳大桥,出境,17145,12965,2924,33034
2024-04-25,落马洲,入境,9380,1972,560,11912
2024-04-25,落马洲,出境,7813,2212,374,10399
2024-04-25,文锦渡,入境,1598,275,11,1884
2024-04-25,文锦渡,出境,1705,237,7,1949
2024-04-25,沙头角,入境,0,0,0,0
2024-04-25,沙头角,出境,0,0,0,0
2024-04-25,深圳湾,入境,23001,7632,1764,32397
2024-04-25,深圳湾,出境,23493,6744,969,31206
2024-04-25,中国客运码头,入境,574,496,255,1325
2024-04-25,中国客运码头,出境,653,522,172,1347
2024-04-25,港口管制,入境,0,0,81,81
2024-04-25,港口管制,出境,3,0,58,61
2024-04-25,启德邮轮码头,入境,0,0,0,0
2024-04-25,启德邮轮码头,出境,1,0,2517,2518
2024-04-25,港澳客轮码头,入境,4142,698,1690,6530
2024-04-25,港澳客轮码头,出境,4210,980,2067,7257
2024-04-26,机场,入境,23463,9317,19437,52217
2024-04-26,机场,出境,31856,11136,17393,60385
2024-04-26,高铁西九龙,入境,13332,13941,3634,30907
2024-04-26,高铁西九龙,出境,20165,10617,1238,32020
2024-04-26,红磡,入境,0,0,0,0
2024-04-26,红磡,出境,0,0,0,0
2024-04-26,罗湖,入境,54141,9538,818,64497
2024-04-26,罗湖,出境,64483,11053,709,76245
2024-04-26,落马洲支线,入境,44460,10356,470,55286
2024-04-26,落马洲支线,出境,55997,10568,335,66900
2024-04-26,香园围,入境,20055,5462,253,25770
2024-04-26,香园围,出境,23786,3178,142,27106
2024-04-26,港珠澳大桥,入境,17283,4995,3686,25964
2024-04-26,港珠澳大桥,出境,25382,10806,3416,39604
2024-04-26,落马洲,入境,9782,2960,880,13622
2024-04-26,落马洲,出境,9963,3039,361,13363
2024-04-26,文锦渡,入境,1466,290,21,1777
2024-04-26,文锦渡,出境,1607,259,11,1877
2024-04-26,沙头角,入境,0,0,0,0
2024-04-26,沙头角,出境,0,0,0,0
2024-04-26,深圳湾,入境,24556,10724,2272,37552
2024-04-26,深圳湾,出境,31031,8514,802,40347
2024-04-26,中国客运码头,入境,971,530,274,1775
2024-04-26,中国客运码头,出境,1184,597,196,1977
2024-04-26,港口管制,入境,0,0,60,60
2024-04-26,港口管制,出境,1,0,47,48
2024-04-26,启德邮轮码头,入境,1246,746,754,2746
2024-04-26,启德邮轮码头,出境,1695,130,750,2575
2024-04-26,港澳客轮码头,入境,4628,693,2110,7431
2024-04-26,港澳客轮码头,出境,6119,953,2142,9214
2024-04-27,机场,入境,25506,9372,20887,55765
2024-04-27,机场,出境,29132,14281,17585,60998
2024-04-27,高铁西九龙,入境,13509,16165,3543,33217
2024-04-27,高铁西九龙,出境,21494,13369,1199,36062
2024-04-27,红磡,入境,0,0,0,0
2024-04-27,红磡,出境,0,0,0,0
2024-04-27,罗湖,入境,71974,12266,966,85206
2024-04-27,罗湖,出境,97035,14226,736,111997
2024-04-27,落马洲支线,入境,62734,15403,522,78659
2024-04-27,落马洲支线,出境,88347,15304,447,104098
2024-04-27,香园围,入境,30286,6500,260,37046
2024-04-27,香园围,出境,39598,4533,109,44240
2024-04-27,港珠澳大桥,入境,21884,5980,5379,33243
2024-04-27,港珠澳大桥,出境,38017,8281,4438,50736
2024-04-27,落马洲,入境,15715,3384,832,19931
2024-04-27,落马洲,出境,16152,2919,364,19435
2024-04-27,文锦渡,入境,1034,414,12,1460
2024-04-27,文锦渡,出境,1703,344,6,2053
2024-04-27,沙头角,入境,0,0,0,0
2024-04-27,沙头角,出境,0,0,0,0
2024-04-27,深圳湾,入境,33164,14090,2251,49505
2024-04-27,深圳湾,出境,45689,10510,937,57136
2024-04-27,中国客运码头,入境,743,579,328,1650
2024-04-27,中国客运码头,出境,1397,488,240,2125
2024-04-27,港口管制,入境,0,0,16,16
2024-04-27,港口管制,出境,0,0,17,17
2024-04-27,启德邮轮码头,入境,0,0,0,0
2024-04-27,启德邮轮码头,出境,0,0,0,0
2024-04-27,港澳客轮码头,入境,5093,686,2761,8540
2024-04-27,港澳客轮码头,出境,8001,861,2991,11853
2024-04-28,机场,入境,31020,10364,14940,56324
2024-04-28,机场,出境,22482,12120,22594,57196
2024-04-28,高铁西九龙,入境,25095,14210,2462,41767
2024-04-28,高铁西九龙,出境,12134,10848,1386,24368
2024-04-28,红磡,入境,0,0,0,0
2024-04-28,红磡,出境,0,0,0,0
2024-04-28,罗湖,入境,99763,11177,914,111854
2024-04-28,罗湖,出境,67619,11438,726,79783
2024-04-28,落马洲支线,入境,84067,11410,453,95930
2024-04-28,落马洲支线,出境,61851,10195,368,72414
2024-04-28,香园围,入境,39713,6300,201,46214
2024-04-28,香园围,出境,30520,4349,166,35035
2024-04-28,港珠澳大桥,入境,43356,6762,5012,55130
2024-04-28,港珠澳大桥,出境,23278,7631,5509,36418
2024-04-28,落马洲,入境,25160,3036,570,28766
2024-04-28,落马洲,出境,11707,2819,361,14887
2024-04-28,文锦渡,入境,1486,342,17,1845
2024-04-28,文锦渡,出境,908,286,3,1197
2024-04-28,沙头角,入境,0,0,0,0
2024-04-28,沙头角,出境,0,0,0,0
2024-04-28,深圳湾,入境,53754,11610,1557,66921
2024-04-28,深圳湾,出境,32905,8735,891,42531
2024-04-28,中国客运码头,入境,1611,530,280,2421
2024-04-28,中国客运码头,出境,700,504,326,1530
2024-04-28,港口管制,入境,23,0,44,67
2024-04-28,港口管制,出境,0,0,36,36
2024-04-28,启德邮轮码头,入境,1699,130,578,2407
2024-04-28,启德邮轮码头,出境,1094,450,548,2092
2024-04-28,港澳客轮码头,入境,8192,693,2247,11132
2024-04-28,港澳客轮码头,出境,4408,1189,3033,8630
2024-04-29,机场,入境,27718,11262,12188,51168
2024-04-29,机场,出境,17558,14977,19217,51752
2024-04-29,高铁西九龙,入境,14586,17307,1853,33746
2024-04-29,高铁西九龙,出境,11625,12854,1675,26154
2024-04-29,红磡,入境,0,0,0,0
2024-04-29,红磡,出境,0,0,0,0
2024-04-29,罗湖,入境,65554,12548,909,79011
2024-04-29,罗湖,出境,62431,12469,844,75744
2024-04-29,落马洲支线,入境,53840,13174,473,67487
2024-04-29,落马洲支线,出境,53097,10970,368,64435
2024-04-29,香园围,入境,27030,5012,220,32262
2024-04-29,香园围,出境,27279,3370,246,30895
2024-04-29,港珠澳大桥,入境,21297,5852,3670,30819
2024-04-29,港珠澳大桥,出境,18475,7446,3325,29246
2024-04-29,落马洲,入境,12446,4757,500,17703
2024-04-29,落马洲,出境,8849,3121,359,12329
2024-04-29,文锦渡,入境,1561,417,18,1996
2024-04-29,文锦渡,出境,1565,342,5,1912
2024-04-29,沙头角,入境,0,0,0,0
2024-04-29,沙头角,出境,0,0,0,0
2024-04-29,深圳湾,入境,29027,13324,1281,43632
2024-04-29,深圳湾,出境,26521,9070,952,36543
2024-04-29,中国客运码头,入境,819,742,283,1844
2024-04-29,中国客运码头,出境,846,701,325,1872
2024-04-29,港口管制,入境,18,4,19,41
2024-04-29,港口管制,出境,3,2,24,29
2024-04-29,启德邮轮码头,入境,0,0,0,0
2024-04-29,启德邮轮码头,出境,6,0,514,520
2024-04-29,港澳客轮码头,入境,5456,1034,2406,8896
2024-04-29,港澳客轮码头,出境,4959,1268,2444,8671
2024-04-30,机场,入境,22249,12827,11577,46653
2024-04-30,机场,出境,21092,23672,17726,62490
2024-04-30,高铁西九龙,入境,13368,26053,1745,41166
2024-04-30,高铁西九龙,出境,14404,13424,2620,30448
2024-04-30,红磡,入境,0,0,0,0
2024-04-30,红磡,出境,0,0,0,0
2024-04-30,罗湖,入境,59054,15318,801,75173
2024-04-30,罗湖,出境,75033,14090,784,89907
2024-04-30,落马洲支线,入境,49170,15347,478,64995
2024-04-30,落马洲支线,出境,59031,11067,313,70411
2024-04-30,香园围,入境,23477,5208,192,28877
2024-04-30,香园围,出境,27040,3207,203,30450
2024-04-30,港珠澳大桥,入境,17976,7594,3993,29563
2024-04-30,港珠澳大桥,出境,24565,8449,3448,36462
2024-04-30,落马洲,入境,10944,6567,753,18264
2024-04-30,落马洲,出境,11586,4359,392,16337
2024-04-30,文锦渡,入境,1390,472,13,1875
2024-04-30,文锦渡,出境,1699,389,14,2102
2024-04-30,沙头角,入境,0,0,0,0
2024-04-30,沙头角,出境,0,0,0,0
2024-04-30,深圳湾,入境,27376,18850,1757,47983
2024-04-30,深圳湾,出境,29270,9215,1230,39715
2024-04-30,中国客运码头,入境,1007,1044,338,2389
2024-04-30,中国客运码头,出境,861,838,336,2035
2024-04-30,港口管制,入境,3,0,37,40
2024-04-30,港口管制,出境,6,2,51,59
2024-04-30,启德邮轮码头,入境,0,0,0,0
2024-04-30,启德邮轮码头,出境,0,0,0,0
2024-04-30,港澳客轮码头,入境,5017,1415,2549,8981
2024-04-30,港澳客轮码头,出境,5991,1827,2409,10227
2024-05-01,机场,入境,31253,16663,16730,64646
2024-05-01,机场,出境,24086,23814,16173,64073
2024-05-01,高铁西九龙,入境,14444,47992,1436,63872
2024-05-01,高铁西九龙,出境,11052,19522,1562,32136
2024-05-01,红磡,入境,0,0,0,0
2024-05-01,红磡,出境,0,0,0,0
2024-05-01,罗湖,入境,61513,28051,709,90273
2024-05-01,罗湖,出境,46798,25049,598,72445
2024-05-01,落马洲支线,入境,48796,29948,459,79203
2024-05-01,落马洲支线,出境,39174,19879,259,59312
2024-05-01,香园围,入境,22899,9698,98,32695
2024-05-01,香园围,出境,19898,3408,75,23381
2024-05-01,港珠澳大桥,入境,28821,9555,3821,42197
2024-05-01,港珠澳大桥,出境,21256,9595,3563,34414
2024-05-01,落马洲,入境,16130,8524,629,25283
2024-05-01,落马洲,出境,9060,4130,299,13489
2024-05-01,文锦渡,入境,1069,948,28,2045
2024-05-01,文锦渡,出境,842,312,20,1174
2024-05-01,沙头角,入境,0,0,0,0
2024-05-01,沙头角,出境,0,0,0,0
2024-05-01,深圳湾,入境,27163,25843,1428,54434
2024-05-01,深圳湾,出境,19544,10862,688,31094
2024-05-01,中国客运码头,入境,898,2388,169,3455
2024-05-01,中国客运码头,出境,632,1015,193,1840
2024-05-01,港口管制,入境,0,0,63,63
2024-05-01,港口管制,出境,4,0,64,68
2024-05-01,启德邮轮码头,入境,0,0,0,0
2024-05-01,启德邮轮码头,出境,0,0,0,0
2024-05-01,港澳客轮码头,入境,5816,1790,1836,9442
2024-05-01,港澳客轮码头,出境,3009,2203,1718,6930
2024-05-02,机场,入境,22871,13907,15144,51922
2024-05-02,机场,出境,20505,15344,13583,49432
2024-05-02,高铁西九龙,入境,10441,38501,1570,50512
2024-05-02,高铁西九龙,出境,9073,24737,1009,34819
2024-05-02,红磡,入境,0,0,0,0
2024-05-02,红磡,出境,0,0,0,0
2024-05-02,罗湖,入境,49135,34142,838,84115
2024-05-02,罗湖,出境,46422,42052,882,89356
2024-05-02,落马洲支线,入境,40061,42589,502,83152
2024-05-02,落马洲支线,出境,39254,35811,450,75515
2024-05-02,香园围,入境,17099,11879,103,29081
2024-05-02,香园围,出境,17465,5552,108,23125
2024-05-02,港珠澳大桥,入境,16146,12781,2898,31825
2024-05-02,港珠澳大桥,出境,15134,17042,2881,35057
2024-05-02,落马洲,入境,9389,6380,417,16186
2024-05-02,落马洲,出境,6950,6294,327,13571
2024-05-02,文锦渡,入境,1506,968,12,2486
2024-05-02,文锦渡,出境,1455,597,7,2059
2024-05-02,沙头角,入境,0,0,0,0
2024-05-02,沙头角,出境,0,0,0,0
2024-05-02,深圳湾,入境,20805,25571,1191,47567
2024-05-02,深圳湾,出境,19141,20782,954,40877
2024-05-02,中国客运码头,入境,740,2342,309,3391
2024-05-02,中国客运码头,出境,661,1838,255,2754
2024-05-02,港口管制,入境,3,3,67,73
2024-05-02,港口管制,出境,19,4,47,70
2024-05-02,启德邮轮码头,入境,0,0,0,0
2024-05-02,启德邮轮码头,出境,0,0,0,0
2024-05-02,港澳客轮码头,入境,3402,2589,2267,8258
2024-05-02,港澳客轮码头,出境,3153,3956,2337,9446
2024-05-03,机场,入境,16975,14305,19394,50674
2024-05-03,机场,出境,22738,10994,12612,46344
2024-05-03,高铁西九龙,入境,9548,36081,1887,47516
2024-05-03,高铁西九龙,出境,12433,28702,1088,42223
2024-05-03,红磡,入境,0,0,0,0
2024-05-03,红磡,出境,0,0,0,0
2024-05-03,罗湖,入境,50715,34934,936,86585
2024-05-03,罗湖,出境,60471,50990,1002,112463
2024-05-03,落马洲支线,入境,41222,44421,535,86178
2024-05-03,落马洲支线,出境,52525,44807,572,97904
2024-05-03,香园围,入境,19206,9527,135,28868
2024-05-03,香园围,出境,22433,6786,100,29319
2024-05-03,港珠澳大桥,入境,16537,13698,3488,33723
2024-05-03,港珠澳大桥,出境,24559,19579,3149,47287
2024-05-03,落马洲,入境,8767,4692,412,13871
2024-05-03,落马洲,出境,9614,8965,411,18990
2024-05-03,文锦渡,入境,1326,1053,15,2394
2024-05-03,文锦渡,出境,1597,716,5,2318
2024-05-03,沙头角,入境,0,0,0,0
2024-05-03,沙头角,出境,0,0,0,0
2024-05-03,深圳湾,入境,21262,24393,1274,46929
2024-05-03,深圳湾,出境,27611,29508,1028,58147
2024-05-03,中国客运码头,入境,727,2195,384,3306
2024-05-03,中国客运码头,出境,1025,2295,309,3629
2024-05-03,港口管制,入境,0,0,41,41
2024-05-03,港口管制,出境,10,3,51,64
2024-05-03,启德邮轮码头,入境,1095,448,606,2149
2024-05-03,启德邮轮码头,出境,1552,234,59,1845
2024-05-03,港澳客轮码头,入境,3460,3327,2758,9545
2024-05-03,港澳客轮码头,出境,4727,5283,3180,13190
2024-05-04,机场,入境,16871,18290,14305,49466
2024-05-04,机场,出境,23089,12700,14904,50693
2024-05-04,高铁西九龙,入境,9974,28282,1907,40163
2024-05-04,高铁西九龙,出境,15797,38190,1166,55153
2024-05-04,红磡,入境,0,0,0,0
2024-05-04,红磡,出境,0,0,0,0
2024-05-04,罗湖,入境,53196,17471,716,71383
2024-05-04,罗湖,出境,71996,33091,831,105918
2024-05-04,落马洲支线,入境,43488,18815,335,62638
2024-05-04,落马洲支线,出境,61428,27279,440,89147
2024-05-04,香园围,入境,18930,4454,84,23468
2024-05-04,香园围,出境,24245,4838,84,29167
2024-05-04,港珠澳大桥,入境,20593,8427,5098,34118
2024-05-04,港珠澳大桥,出境,31389,13316,4280,48985
2024-05-04,落马洲,入境,10825,2579,320,13724
2024-05-04,落马洲,出境,11663,11113,400,23176
2024-05-04,文锦渡,入境,838,423,42,1303
2024-05-04,文锦渡,出境,1076,396,10,1482
2024-05-04,沙头角,入境,0,0,0,0
2024-05-04,沙头角,出境,0,0,0,0
2024-05-04,深圳湾,入境,19519,11887,1047,32453
2024-05-04,深圳湾,出境,28988,24047,1201,54236
2024-05-04,中国客运码头,入境,601,1093,303,1997
2024-05-04,中国客运码头,出境,1038,1771,306,3115
2024-05-04,港口管制,入境,5,0,13,18
2024-05-04,港口管制,出境,1,1,45,47
2024-05-04,启德邮轮码头,入境,0,0,0,0
2024-05-04,启德邮轮码头,出境,0,0,0,0
2024-05-04,港澳客轮码头,入境,3704,2076,3359,9139
2024-05-04,港澳客轮码头,出境,6230,2741,3633,12604
2024-05-05,机场,入境,31615,30404,13150,75169
2024-05-05,机场,出境,23024,13615,22100,58739
2024-05-05,高铁西九龙,入境,18321,12629,1609,32559
2024-05-05,高铁西九龙,出境,11677,32503,1656,45836
2024-05-05,红磡,入境,0,0,0,0
2024-05-05,红磡,出境,0,0,0,0
2024-05-05,罗湖,入境,86233,11566,646,98445
2024-05-05,罗湖,出境,62587,21794,671,85052
2024-05-05,落马洲支线,入境,70065,13471,285,83821
2024-05-05,落马洲支线,出境,56071,17592,466,74129
2024-05-05,香园围,入境,36172,3674,145,39991
2024-05-05,香园围,出境,29460,3887,136,33483
2024-05-05,港珠澳大桥,入境,38783,5719,5132,49634
2024-05-05,港珠澳大桥,出境,22674,7682,5366,35722
2024-05-05,落马洲,入境,18563,1749,372,20684
2024-05-05,落马洲,出境,11350,12758,1086,25194
2024-05-05,文锦渡,入境,1351,439,10,1800
2024-05-05,文锦渡,出境,889,434,5,1328
2024-05-05,沙头角,入境,0,0,0,0
2024-05-05,沙头角,出境,0,0,0,0
2024-05-05,深圳湾,入境,42384,8898,1055,52337
2024-05-05,深圳湾,出境,31071,23331,1867,56269
2024-05-05,中国客运码头,入境,1420,514,300,2234
2024-05-05,中国客运码头,出境,660,1108,373,2141
2024-05-05,港口管制,入境,10,0,20,30
2024-05-05,港口管制,出境,13,3,4,20
2024-05-05,启德邮轮码头,入境,1552,234,37,1823
2024-05-05,启德邮轮码头,出境,1421,244,115,1780
2024-05-05,港澳客轮码头,入境,6563,959,2790,10312
2024-05-05,港澳客轮码头,出境,4525,1185,3693,9403
2024-05-06,机场,入境,24074,24475,14142,62691
2024-05-06,机场,出境,22399,9192,20542,52133
2024-05-06,高铁西九龙,入境,13086,12077,1364,26527
2024-05-06,高铁西九龙,出境,12735,12886,1404,27025
2024-05-06,红磡,入境,0,0,0,0
2024-05-06,红磡,出境,0,0,0,0
2024-05-06,罗湖,入境,62668,11011,610,74289
2024-05-06,罗湖,出境,59685,12179,665,72529
2024-05-06,落马洲支线,入境,49769,10210,248,60227
2024-05-06,落马洲支线,出境,50330,10327,380,61037
2024-05-06,香园围,入境,25437,3531,108,29076
2024-05-06,香园围,出境,25487,2604,176,28267
2024-05-06,港珠澳大桥,入境,18712,4178,3279,26169
2024-05-06,港珠澳大桥,出境,17541,4927,2817,25285
2024-05-06,落马洲,入境,11950,2620,257,14827
2024-05-06,落马洲,出境,8644,7790,806,17240
2024-05-06,文锦渡,入境,1440,337,10,1787
2024-05-06,文锦渡,出境,1487,312,8,1807
2024-05-06,沙头角,入境,0,0,0,0
2024-05-06,沙头角,出境,0,0,0,0
2024-05-06,深圳湾,入境,25619,8235,920,34774
2024-05-06,深圳湾,出境,25860,13418,1453,40731
2024-05-06,中国客运码头,入境,718,538,197,1453
2024-05-06,中国客运码头,出境,827,512,248,1587
2024-05-06,港口管制,入境,5,0,29,34
2024-05-06,港口管制,出境,5,1,57,63
2024-05-06,启德邮轮码头,入境,0,0,0,0
2024-05-06,启德邮轮码头,出境,0,0,0,0
2024-05-06,港澳客轮码头,入境,5347,651,2027,8025
2024-05-06,港澳客轮码头,出境,4585,857,2191,7633
2024-05-07,机场,入境,19954,15227,12840,48021
2024-05-07,机场,出境,25739,7403,12421,45563
2024-05-07,高铁西九龙,入境,10527,13889,1028,25444
2024-05-07,高铁西九龙,出境,11117,10617,1081,22815
2024-05-07,红磡,入境,0,0,0,0
2024-05-07,红磡,出境,0,0,0,0
2024-05-07,罗湖,入境,58966,10761,544,70271
2024-05-07,罗湖,出境,58295,12073,656,71024
2024-05-07,落马洲支线,入境,47209,11366,306,58881
2024-05-07,落马洲支线,出境,49400,10146,338,59884
2024-05-07,香园围,入境,24695,4560,96,29351
2024-05-07,香园围,出境,24993,2530,120,27643
2024-05-07,港珠澳大桥,入境,16446,4549,2889,23884
2024-05-07,港珠澳大桥,出境,17018,5279,2886,25183
2024-05-07,落马洲,入境,9643,2181,227,12051
2024-05-07,落马洲,出境,8530,6149,494,15173
2024-05-07,文锦渡,入境,1451,342,4,1797
2024-05-07,文锦渡,出境,1562,290,8,1860
2024-05-07,沙头角,入境,0,0,0,0
2024-05-07,沙头角,出境,0,0,0,0
2024-05-07,深圳湾,入境,23848,8702,773,33323
2024-05-07,深圳湾,出境,24352,10692,1029,36073
2024-05-07,中国客运码头,入境,612,494,186,1292
2024-05-07,中国客运码头,出境,685,452,138,1275
2024-05-07,港口管制,入境,0,0,34,34
2024-05-07,港口管制,出境,94,1,35,130
2024-05-07,启德邮轮码头,入境,0,0,0,0
2024-05-07,启德邮轮码头,出境,0,0,0,0
2024-05-07,港澳客轮码头,入境,4718,642,1591,6951
2024-05-07,港澳客轮码头,出境,4415,663,1722,6800
2024-05-08,机场,入境,19138,10574,14468,44180
2024-05-08,机场,出境,27875,6483,10866,45224
2024-05-08,高铁西九龙,入境,10469,11998,1140,23607
2024-05-08,高铁西九龙,出境,13014,10490,1115,24619
2024-05-08,红磡,入境,0,0,0,0
2024-05-08,红磡,出境,0,0,0,0
2024-05-08,罗湖,入境,58532,10397,538,69467
2024-05-08,罗湖,出境,58697,11710,686,71093
2024-05-08,落马洲支线,入境,47965,10654,311,58930
2024-05-08,落马洲支线,出境,49882,9668,359,59909
2024-05-08,香园围,入境,22831,6113,147,29091
2024-05-08,香园围,出境,24066,2982,230,27278
2024-05-08,港珠澳大桥,入境,16091,4230,3133,23454
2024-05-08,港珠澳大桥,出境,16364,6452,3133,25949
2024-05-08,落马洲,入境,9955,1974,237,12166
2024-05-08,落马洲,出境,8721,4591,353,13665
2024-05-08,文锦渡,入境,1379,335,6,1720
2024-05-08,文锦渡,出境,1463,329,8,1800
2024-05-08,沙头角,入境,0,0,0,0
2024-05-08,沙头角,出境,0,0,0,0
2024-05-08,深圳湾,入境,23526,7786,677,31989
2024-05-08,深圳湾,出境,24494,8304,876,33674
2024-05-08,中国客运码头,入境,608,465,274,1347
2024-05-08,中国客运码头,出境,666,481,217,1364
2024-05-08,港口管制,入境,1,0,36,37
2024-05-08,港口管制,出境,0,0,25,25
2024-05-08,启德邮轮码头,入境,0,0,0,0
2024-05-08,启德邮轮码头,出境,0,0,0,0
2024-05-08,港澳客轮码头,入境,4520,748,1790,7058
2024-05-08,港澳客轮码头,出境,4498,1022,2284,7804
2024-05-09,机场,入境,18474,7300,14725,40499
2024-05-09,机场,出境,30143,6727,11509,48379
2024-05-09,高铁西九龙,入境,11627,14243,1174,27044
2024-05-09,高铁西九龙,出境,12931,11201,1161,25293
2024-05-09,红磡,入境,0,0,0,0
2024-05-09,红磡,出境,0,0,0,0
2024-05-09,罗湖,入境,59773,11664,639,72076
2024-05-09,罗湖,出境,59470,12454,695,72619
2024-05-09,落马洲支线,入境,48775,12771,330,61876
2024-05-09,落马洲支线,出境,51251,10960,381,62592
2024-05-09,香园围,入境,24977,6959,134,32070
2024-05-09,香园围,出境,26353,2977,108,29438
2024-05-09,港珠澳大桥,入境,17246,4539,3544,25329
2024-05-09,港珠澳大桥,出境,18787,8538,3187,30512
2024-05-09,落马洲,入境,10165,2162,299,12626
2024-05-09,落马洲,出境,8722,3816,338,12876
2024-05-09,文锦渡,入境,1479,369,11,1859
2024-05-09,文锦渡,出境,1581,336,9,1926
2024-05-09,沙头角,入境,0,0,0,0
2024-05-09,沙头角,出境,0,0,0,0
2024-05-09,深圳湾,入境,25114,9136,859,35109
2024-05-09,深圳湾,出境,25765,8901,838,35504
2024-05-09,中国客运码头,入境,585,516,178,1279
2024-05-09,中国客运码头,出境,597,582,188,1367
2024-05-09,港口管制,入境,0,0,46,46
2024-05-09,港口管制,出境,37,0,50,87
2024-05-09,启德邮轮码头,入境,0,0,0,0
2024-05-09,启德邮轮码头,出境,0,0,0,0
2024-05-09,港澳客轮码头,入境,4771,745,1829,7345
2024-05-09,港澳客轮码头,出境,4899,1061,2006,7966
2024-05-10,机场,入境,21914,7018,15698,44630
2024-05-10,机场,出境,37172,6620,13727,57519
2024-05-10,高铁西九龙,入境,13183,11022,1271,25476
2024-05-10,高铁西九龙,出境,21481,12514,1186,35181
2024-05-10,红磡,入境,0,0,0,0
2024-05-10,红磡,出境,0,0,0,0
2024-05-10,罗湖,入境,61080,10324,637,72041
2024-05-10,罗湖,出境,72830,14061,773,87664
2024-05-10,落马洲支线,入境,50087,11301,405,61793
2024-05-10,落马洲支线,出境,62911,12533,369,75813
2024-05-10,香园围,入境,25659,5494,138,31291
2024-05-10,香园围,出境,29641,3462,184,33287
2024-05-10,港珠澳大桥,入境,18784,4472,3927,27183
2024-05-10,港珠澳大桥,出境,27437,8907,3110,39454
2024-05-10,落马洲,入境,10975,1832,447,13254
2024-05-10,落马洲,出境,11148,5161,295,16604
2024-05-10,文锦渡,入境,1485,341,16,1842
2024-05-10,文锦渡,出境,1849,338,6,2193
2024-05-10,沙头角,入境,0,0,0,0
2024-05-10,沙头角,出境,0,0,0,0
2024-05-10,深圳湾,入境,27791,8371,1081,37243
2024-05-10,深圳湾,出境,34578,9444,739,44761
2024-05-10,中国客运码头,入境,808,506,223,1537
2024-05-10,中国客运码头,出境,1078,638,185,1901
2024-05-10,港口管制,入境,40,0,23,63
2024-05-10,港口管制,出境,2,3,18,23
2024-05-10,启德邮轮码头,入境,1420,244,114,1778
2024-05-10,启德邮轮码头,出境,1505,111,101,1717
2024-05-10,港澳客轮码头,入境,5540,705,2422,8667
2024-05-10,港澳客轮码头,出境,7093,1052,2292,10437
2024-05-11,机场,入境,23488,5988,15086,44562
2024-05-11,机场,出境,37935,5702,13352,56989
2024-05-11,高铁西九龙,入境,13857,11542,1237,26636
2024-05-11,高铁西九龙,出境,25112,11213,1062,37387
2024-05-11,红磡,入境,0,0,0,0
2024-05-11,红磡,出境,0,0,0,0
2024-05-11,罗湖,入境,75201,10955,657,86813
2024-05-11,罗湖,出境,106964,12620,773,120357
2024-05-11,落马洲支线,入境,64801,12380,366,77547
2024-05-11,落马洲支线,出境,98245,12549,383,111177
2024-05-11,香园围,入境,31519,6720,103,38342
2024-05-11,香园围,出境,43806,3980,254,48040
2024-05-11,港珠澳大桥,入境,22942,5450,5652,34044
2024-05-11,港珠澳大桥,出境,38802,7941,4632,51375
2024-05-11,落马洲,入境,16795,1763,426,18984
2024-05-11,落马洲,出境,17351,2548,316,20215
2024-05-11,文锦渡,入境,1136,365,11,1512
2024-05-11,文锦渡,出境,1794,336,10,2140
2024-05-11,沙头角,入境,0,0,0,0
2024-05-11,沙头角,出境,0,0,0,0
2024-05-11,深圳湾,入境,35844,8861,948,45653
2024-05-11,深圳湾,出境,55041,9087,781,64909
2024-05-11,中国客运码头,入境,715,459,252,1426
2024-05-11,中国客运码头,出境,1355,535,225,2115
2024-05-11,港口管制,入境,94,0,46,140
2024-05-11,港口管制,出境,3,0,46,49
2024-05-11,启德邮轮码头,入境,0,0,0,0
2024-05-11,启德邮轮码头,出境,0,0,0,0
2024-05-11,港澳客轮码头,入境,5728,584,2398,8710
2024-05-11,港澳客轮码头,出境,7467,952,2548,10967
2024-05-12,机场,入境,30221,7797,13315,51333
2024-05-12,机场,出境,30626,6660,18393,55679
2024-05-12,高铁西九龙,入境,26305,13295,1006,40606
2024-05-12,高铁西九龙,出境,13493,13261,1369,28123
2024-05-12,红磡,入境,0,0,0,0
2024-05-12,红磡,出境,0,0,0,0
2024-05-12,罗湖,入境,113569,12307,592,126468
2024-05-12,罗湖,出境,71655,14524,667,86846
2024-05-12,落马洲支线,入境,96320,16939,379,113638
2024-05-12,落马洲支线,出境,68384,16121,442,84947
2024-05-12,香园围,入境,44006,8636,139,52781
2024-05-12,香园围,出境,35332,4012,153,39497
2024-05-12,港珠澳大桥,入境,44796,5002,4261,54059
2024-05-12,港珠澳大桥,出境,24833,7781,4681,37295
2024-05-12,落马洲,入境,26537,2179,250,28966
2024-05-12,落马洲,出境,12670,2771,436,15877
2024-05-12,文锦渡,入境,1928,412,0,2340
2024-05-12,文锦渡,出境,1142,327,9,1478
2024-05-12,沙头角,入境,0,0,0,0
2024-05-12,沙头角,出境,0,0,0,0
2024-05-12,深圳湾,入境,66653,10405,792,77850
2024-05-12,深圳湾,出境,41290,10174,1207,52671
2024-05-12,中国客运码头,入境,1436,547,229,2212
2024-05-12,中国客运码头,出境,590,506,298,1394
2024-05-12,港口管制,入境,0,3,41,44
2024-05-12,港口管制,出境,97,3,27,127
2024-05-12,启德邮轮码头,入境,1502,111,82,1695
2024-05-12,启德邮轮码头,出境,1408,306,96,1810
2024-05-12,港澳客轮码头,入境,8649,723,1766,11138
2024-05-12,港澳客轮码头,出境,4954,1023,2891,8868
2024-05-13,机场,入境,23814,7875,13163,44852
2024-05-13,机场,出境,28694,5868,13823,48385
2024-05-13,高铁西九龙,入境,13546,11607,1057,26210
2024-05-13,高铁西九龙,出境,13809,9729,1221,24759
2024-05-13,红磡,入境,0,0,0,0
2024-05-13,红磡,出境,0,0,0,0
2024-05-13,罗湖,入境,62344,11037,751,74132
2024-05-13,罗湖,出境,60220,11115,813,72148
2024-05-13,落马洲支线,入境,50821,10532,342,61695
2024-05-13,落马洲支线,出境,51487,9801,405,61693
2024-05-13,香园围,入境,24697,6278,111,31086
2024-05-13,香园围,出境,25087,2556,201,27844
2024-05-13,港珠澳大桥,入境,20881,4982,3302,29165
2024-05-13,港珠澳大桥,出境,19227,8668,2714,30609
2024-05-13,落马洲,入境,11048,2730,272,14050
2024-05-13,落马洲,出境,8514,2646,565,11725
2024-05-13,文锦渡,入境,1508,324,8,1840
2024-05-13,文锦渡,出境,1544,276,5,1825
2024-05-13,沙头角,入境,0,0,0,0
2024-05-13,沙头角,出境,0,0,0,0
2024-05-13,深圳湾,入境,26950,8726,667,36343
2024-05-13,深圳湾,出境,26672,7763,1213,35648
2024-05-13,中国客运码头,入境,692,530,179,1401
2024-05-13,中国客运码头,出境,874,429,242,1545
2024-05-13,港口管制,入境,2,0,31,33
2024-05-13,港口管制,出境,2,0,27,29
2024-05-13,启德邮轮码头,入境,0,0,0,0
2024-05-13,启德邮轮码头,出境,0,0,0,0
2024-05-13,港澳客轮码头,入境,5625,785,2233,8643
2024-05-13,港澳客轮码头,出境,4919,805,2555,8279
2024-05-14,机场,入境,25531,6522,12131,44184
2024-05-14,机场,出境,32911,5538,12696,51145
2024-05-14,高铁西九龙,入境,11558,11255,895,23708
2024-05-14,高铁西九龙,出境,17581,10488,1024,29093
2024-05-14,红磡,入境,0,0,0,0
2024-05-14,红磡,出境,0,0,0,0
2024-05-14,罗湖,入境,61098,10994,696,72788
2024-05-14,罗湖,出境,79553,12606,676,92835
2024-05-14,落马洲支线,入境,49438,11040,329,60807
2024-05-14,落马洲支线,出境,67916,11476,363,79755
2024-05-14,香园围,入境,25924,6237,214,32375
2024-05-14,香园围,出境,30523,3244,121,33888
2024-05-14,港珠澳大桥,入境,17875,5171,3491,26537
2024-05-14,港珠澳大桥,出境,30768,8726,3223,42717
2024-05-14,落马洲,入境,10027,2041,242,12310
2024-05-14,落马洲,出境,13202,2464,402,16068
2024-05-14,文锦渡,入境,1450,351,11,1812
2024-05-14,文锦渡,出境,1914,314,9,2237
2024-05-14,沙头角,入境,0,0,0,0
2024-05-14,沙头角,出境,0,0,0,0
2024-05-14,深圳湾,入境,26299,8698,772,35769
2024-05-14,深圳湾,出境,34039,8387,1079,43505
2024-05-14,中国客运码头,入境,564,452,172,1188
2024-05-14,中国客运码头,出境,922,470,259,1651
2024-05-14,港口管制,入境,3,2,33,38
2024-05-14,港口管制,出境,3,0,26,29
2024-05-14,启德邮轮码头,入境,0,0,0,0
2024-05-14,启德邮轮码头,出境,0,0,0,0
2024-05-14,港澳客轮码头,入境,4854,712,2090,7656
2024-05-14,港澳客轮码头,出境,8100,1029,2234,11363
2024-05-15,机场,入境,34932,7193,13960,56085
2024-05-15,机场,出境,38897,5300,12923,57120
2024-05-15,高铁西九龙,入境,21837,10436,977,33250
2024-05-15,高铁西九龙,出境,19783,8919,1029,29731
2024-05-15,红磡,入境,0,0,0,0
2024-05-15,红磡,出境,0,0,0,0
2024-05-15,罗湖,入境,111038,10212,627,121877
2024-05-15,罗湖,出境,94128,10479,611,105218
2024-05-15,落马洲支线,入境,98586,10360,316,109262
2024-05-15,落马洲支线,出境,89816,9374,321,99511
2024-05-15,香园围,入境,44118,7454,106,51678
2024-05-15,香园围,出境,43481,2785,116,46382
2024-05-15,港珠澳大桥,入境,41597,5113,5291,52001
2024-05-15,港珠澳大桥,出境,32932,8681,5312,46925
2024-05-15,落马洲,入境,25996,1933,367,28296
2024-05-15,落马洲,出境,15936,2336,330,18602
2024-05-15,文锦渡,入境,1587,317,8,1912
2024-05-15,文锦渡,出境,1342,255,7,1604
2024-05-15,沙头角,入境,0,0,0,0
2024-05-15,沙头角,出境,0,0,0,0
2024-05-15,深圳湾,入境,55201,7831,847,63879
2024-05-15,深圳湾,出境,46882,6802,756,54440
2024-05-15,中国客运码头,入境,981,413,261,1655
2024-05-15,中国客运码头,出境,866,493,217,1576
2024-05-15,港口管制,入境,0,0,17,17
2024-05-15,港口管制,出境,1,0,47,48
2024-05-15,启德邮轮码头,入境,0,0,0,0
2024-05-15,启德邮轮码头,出境,0,0,0,0
2024-05-15,港澳客轮码头,入境,8501,750,2131,11382
2024-05-15,港澳客轮码头,出境,6024,1160,2217,9401
2024-05-16,机场,入境,27279,8781,14557,50617
2024-05-16,机场,出境,27964,6340,11957,46261
2024-05-16,高铁西九龙,入境,12956,14331,1227,28514
2024-05-16,高铁西九龙,出境,13013,11905,997,25915
2024-05-16,红磡,入境,0,0,0,0
2024-05-16,红磡,出境,0,0,0,0
2024-05-16,罗湖,入境,61405,11349,658,73412
2024-05-16,罗湖,出境,58219,12634,711,71564
2024-05-16,落马洲支线,入境,50467,11548,353,62368
2024-05-16,落马洲支线,出境,49536,11024,314,60874
2024-05-16,香园围,入境,26063,7007,123,33193
2024-05-16,香园围,出境,26199,2908,95,29202
2024-05-16,港珠澳大桥,入境,21772,5506,3170,30448
2024-05-16,港珠澳大桥,出境,20633,10652,2796,34081
2024-05-16,落马洲,入境,12265,2313,397,14975
2024-05-16,落马洲,出境,8354,2740,287,11381
2024-05-16,文锦渡,入境,1502,384,7,1893
2024-05-16,文锦渡,出境,1571,329,3,1903
2024-05-16,沙头角,入境,0,0,0,0
2024-05-16,沙头角,出境,0,0,0,0
2024-05-16,深圳湾,入境,26251,9641,915,36807
2024-05-16,深圳湾,出境,26235,8983,816,36034
2024-05-16,中国客运码头,入境,806,570,232,1608
2024-05-16,中国客运码头,出境,768,566,196,1530
2024-05-16,港口管制,入境,0,29,20,49
2024-05-16,港口管制,出境,2,29,11,42
2024-05-16,启德邮轮码头,入境,0,0,0,0
2024-05-16,启德邮轮码头,出境,0,0,0,0
2024-05-16,港澳客轮码头,入境,5987,858,2104,8949
2024-05-16,港澳客轮码头,出境,6567,1119,2291,9977
2024-05-17,机场,入境,27070,9254,16552,52876
2024-05-17,机场,出境,30715,6906,13186,50807
2024-05-17,高铁西九龙,入境,13672,17220,1323,32215
2024-05-17,高铁西九龙,出境,20770,12917,1057,34744
2024-05-17,红磡,入境,0,0,0,0
2024-05-17,红磡,出境,0,0,0,0
2024-05-17,罗湖,入境,59570,12692,675,72937
2024-05-17,罗湖,出境,70954,13865,715,85534
2024-05-17,落马洲支线,入境,49523,13421,407,63351
2024-05-17,落马洲支线,出境,60158,12738,366,73262
2024-05-17,香园围,入境,26899,7778,172,34849
2024-05-17,香园围,出境,30532,3876,161,34569
2024-05-17,港珠澳大桥,入境,21526,5298,3922,30746
2024-05-17,港珠澳大桥,出境,31366,9797,3253,44416
2024-05-17,落马洲,入境,10399,2310,508,13217
2024-05-17,落马洲,出境,10702,2791,290,13783
2024-05-17,文锦渡,入境,1496,398,19,1913
2024-05-17,文锦渡,出境,1797,337,12,2146
2024-05-17,沙头角,入境,0,0,0,0
2024-05-17,沙头角,出境,0,0,0,0
2024-05-17,深圳湾,入境,27240,11047,1281,39568
2024-05-17,深圳湾,出境,35044,10636,833,46513
2024-05-17,中国客运码头,入境,891,612,253,1756
2024-05-17,中国客运码头,出境,1153,645,274,2072
2024-05-17,港口管制,入境,100,0,76,176
2024-05-17,港口管制,出境,6,0,42,48
2024-05-17,启德邮轮码头,入境,1410,303,90,1803
2024-05-17,启德邮轮码头,出境,1769,111,85,1965
2024-05-17,港澳客轮码头,入境,6294,964,2723,9981
2024-05-17,港澳客轮码头,出境,9790,1113,3032,13935
2024-05-18,机场,入境,32682,8534,15554,56770
2024-05-18,机场,出境,29628,7249,14954,51831
2024-05-18,高铁西九龙,入境,14900,28426,1435,44761
2024-05-18,高铁西九龙,出境,20896,19788,1143,41827
2024-05-18,红磡,入境,0,0,0,0
2024-05-18,红磡,出境,0,0,0,0
2024-05-18,罗湖,入境,72639,18760,699,92098
2024-05-18,罗湖,出境,97755,21931,776,120462
2024-05-18,落马洲支线,入境,61966,24722,535,87223
2024-05-18,落马洲支线,出境,86479,22022,436,108937
2024-05-18,香园围,入境,32107,10002,117,42226
2024-05-18,香园围,出境,41674,6231,255,48160
2024-05-18,港珠澳大桥,入境,27179,8176,5392,40747
2024-05-18,港珠澳大桥,出境,43883,11142,4522,59547
2024-05-18,落马洲,入境,15431,2888,409,18728
2024-05-18,落马洲,出境,16201,6020,321,22542
2024-05-18,文锦渡,入境,1053,670,25,1748
2024-05-18,文锦渡,出境,2013,478,21,2512
2024-05-18,沙头角,入境,0,0,0,0
2024-05-18,沙头角,出境,0,0,0,0
2024-05-18,深圳湾,入境,33665,16880,1100,51645
2024-05-18,深圳湾,出境,47299,15382,1006,63687
2024-05-18,中国客运码头,入境,711,904,218,1833
2024-05-18,中国客运码头,出境,1495,640,172,2307
2024-05-18,港口管制,入境,3,0,29,32
2024-05-18,港口管制,出境,1,0,34,35
2024-05-18,启德邮轮码头,入境,0,0,0,0
2024-05-18,启德邮轮码头,出境,0,0,0,0
2024-05-18,港澳客轮码头,入境,6836,1063,2905,10804
2024-05-18,港澳客轮码头,出境,10740,1343,2449,14532
2024-05-19,机场,入境,46268,7205,12441,65914
2024-05-19,机场,出境,28566,9520,18693,56779
2024-05-19,高铁西九龙,入境,26314,12540,1011,39865
2024-05-19,高铁西九龙,出境,12354,22178,1286,35818
2024-05-19,红磡,入境,0,0,0,0
2024-05-19,红磡,出境,0,0,0,0
2024-05-19,罗湖,入境,99733,12217,746,112696
2024-05-19,罗湖,出境,64317,17170,773,82260
2024-05-19,落马洲支线,入境,77849,14138,373,92360
2024-05-19,落马洲支线,出境,56952,15970,381,73303
2024-05-19,香园围,入境,39954,8376,168,48498
2024-05-19,香园围,出境,29572,6433,164,36169
2024-05-19,港珠澳大桥,入境,51072,7015,4311,62398
2024-05-19,港珠澳大桥,出境,24987,9955,4851,39793
2024-05-19,落马洲,入境,23296,2036,232,25564
2024-05-19,落马洲,出境,11336,3432,437,15205
2024-05-19,文锦渡,入境,1698,374,3,2075
2024-05-19,文锦渡,出境,955,340,2,1297
2024-05-19,沙头角,入境,0,0,0,0
2024-05-19,沙头角,出境,0,0,0,0
2024-05-19,深圳湾,入境,53312,9451,832,63595
2024-05-19,深圳湾,出境,30680,13297,1058,45035
2024-05-19,中国客运码头,入境,1591,453,194,2238
2024-05-19,中国客运码头,出境,685,805,266,1756
2024-05-19,港口管制,入境,0,0,129,129
2024-05-19,港口管制,出境,0,0,33,33
2024-05-19,启德邮轮码头,入境,1769,111,66,1946
2024-05-19,启德邮轮码头,出境,77,225,155,457
2024-05-19,港澳客轮码头,入境,10888,708,1686,13282
2024-05-19,港澳客轮码头,出境,5919,1051,2281,9251
2024-05-20,机场,入境,35424,8447,13923,57794
2024-05-20,机场,出境,28665,6807,13860,49332
2024-05-20,高铁西九龙,入境,14661,11075,969,26705
2024-05-20,高铁西九龙,出境,12369,10112,1262,23743
2024-05-20,红磡,入境,0,0,0,0
2024-05-20,红磡,出境,0,0,0,0
2024-05-20,罗湖,入境,61678,10274,630,72582
2024-05-20,罗湖,出境,56619,10529,624,67772
2024-05-20,落马洲支线,入境,48823,9708,310,58841
2024-05-20,落马洲支线,出境,47956,8882,360,57198
2024-05-20,香园围,入境,21977,6319,108,28404
2024-05-20,香园围,出境,21671,2555,204,24430
2024-05-20,港珠澳大桥,入境,23639,5150,2905,31694
2024-05-20,港珠澳大桥,出境,15809,8087,3007,26903
2024-05-20,落马洲,入境,11566,2567,249,14382
2024-05-20,落马洲,出境,8040,2699,521,11260
2024-05-20,文锦渡,入境,1512,266,8,1786
2024-05-20,文锦渡,出境,1521,245,15,1781
2024-05-20,沙头角,入境,0,0,0,0
2024-05-20,沙头角,出境,0,0,0,0
2024-05-20,深圳湾,入境,26792,7723,733,35248
2024-05-20,深圳湾,出境,23946,7467,1207,32620
2024-05-20,中国客运码头,入境,721,417,171,1309
2024-05-20,中国客运码头,出境,700,479,248,1427
2024-05-20,港口管制,入境,0,0,24,24
2024-05-20,港口管制,出境,0,0,48,48
2024-05-20,启德邮轮码头,入境,0,0,0,0
2024-05-20,启德邮轮码头,出境,0,0,0,0
2024-05-20,港澳客轮码头,入境,6687,585,1752,9024
2024-05-20,港澳客轮码头,出境,4345,808,2175,7328
2024-05-21,机场,入境,29174,8001,13138,50313
2024-05-21,机场,出境,25219,5951,12766,43936
2024-05-21,高铁西九龙,入境,11698,10258,1076,23032
2024-05-21,高铁西九龙,出境,10541,9274,1245,21060
2024-05-21,红磡,入境,0,0,0,0
2024-05-21,红磡,出境,0,0,0,0
2024-05-21,罗湖,入境,54350,9168,579,64097
2024-05-21,罗湖,出境,51777,10131,689,62597
2024-05-21,落马洲支线,入境,43850,9394,283,53527
2024-05-21,落马洲支线,出境,44053,9050,307,53410
2024-05-21,香园围,入境,20411,6909,97,27417
2024-05-21,香园围,出境,20383,2471,119,22973
2024-05-21,港珠澳大桥,入境,15510,4325,2872,22707
2024-05-21,港珠澳大桥,出境,14908,9353,2927,27188
2024-05-21,落马洲,入境,9481,1839,281,11601
2024-05-21,落马洲,出境,7634,2295,435,10364
2024-05-21,文锦渡,入境,1351,250,40,1641
2024-05-21,文锦渡,出境,1421,231,8,1660
2024-05-21,沙头角,入境,0,0,0,0
2024-05-21,沙头角,出境,0,0,0,0
2024-05-21,深圳湾,入境,22402,7073,729,30204
2024-05-21,深圳湾,出境,20930,6693,1044,28667
2024-05-21,中国客运码头,入境,568,461,201,1230
2024-05-21,中国客运码头,出境,607,389,168,1164
2024-05-21,港口管制,入境,4,0,107,111
2024-05-21,港口管制,出境,0,0,94,94
2024-05-21,启德邮轮码头,入境,0,0,0,0
2024-05-21,启德邮轮码头,出境,0,0,0,0
2024-05-21,港澳客轮码头,入境,4246,601,1805,6652
2024-05-21,港澳客轮码头,出境,3860,790,2236,6886
2024-05-22,机场,入境,25134,7910,15571,48615
2024-05-22,机场,出境,27047,5835,12408,45290
2024-05-22,高铁西九龙,入境,10973,10795,1188,22956
2024-05-22,高铁西九龙,出境,11104,9963,1250,22317
2024-05-22,红磡,入境,0,0,0,0
2024-05-22,红磡,出境,0,0,0,0
2024-05-22,罗湖,入境,54908,9794,589,65291
2024-05-22,罗湖,出境,53776,10785,657,65218
2024-05-22,落马洲支线,入境,46479,10294,305,57078
2024-05-22,落马洲支线,出境,47729,10013,345,58087
2024-05-22,香园围,入境,23684,7009,128,30821
2024-05-22,香园围,出境,23807,3104,171,27082
2024-05-22,港珠澳大桥,入境,15528,4965,3375,23868
2024-05-22,港珠澳大桥,出境,15471,9323,3008,27802
2024-05-22,落马洲,入境,9316,1948,335,11599
2024-05-22,落马洲,出境,8052,2458,366,10876
2024-05-22,文锦渡,入境,1456,368,19,1843
2024-05-22,文锦渡,出境,1558,324,7,1889
2024-05-22,沙头角,入境,0,0,0,0
2024-05-22,沙头角,出境,0,0,0,0
2024-05-22,深圳湾,入境,23483,7413,851,31747
2024-05-22,深圳湾,出境,22924,7167,1000,31091
2024-05-22,中国客运码头,入境,501,477,219,1197
2024-05-22,中国客运码头,出境,561,573,231,1365
2024-05-22,港口管制,入境,1,4,7,12
2024-05-22,港口管制,出境,7,0,44,51
2024-05-22,启德邮轮码头,入境,0,0,0,0
2024-05-22,启德邮轮码头,出境,0,0,0,0
2024-05-22,港澳客轮码头,入境,4171,826,1958,6955
2024-05-22,港澳客轮码头,出境,4152,1157,2343,7652
2024-05-23,机场,入境,23142,8646,16011,47799
2024-05-23,机场,出境,30388,5849,12118,48355
2024-05-23,高铁西九龙,入境,11075,11644,1183,23902
2024-05-23,高铁西九龙,出境,12101,9852,1246,23199
2024-05-23,红磡,入境,0,0,0,0
2024-05-23,红磡,出境,0,0,0,0
2024-05-23,罗湖,入境,56905,9568,721,67194
2024-05-23,罗湖,出境,55920,10639,783,67342
2024-05-23,落马洲支线,入境,46799,9893,358,57050
2024-05-23,落马洲支线,出境,48668,9667,333,58668
2024-05-23,香园围,入境,24344,6306,147,30797
2024-05-23,香园围,出境,25526,2534,161,28221
2024-05-23,港珠澳大桥,入境,16074,4322,3216,23612
2024-05-23,港珠澳大桥,出境,17289,9280,2879,29448
2024-05-23,落马洲,入境,9438,1892,336,11666
2024-05-23,落马洲,出境,8026,2347,390,10763
2024-05-23,文锦渡,入境,1434,355,12,1801
2024-05-23,文锦渡,出境,1539,297,11,1847
2024-05-23,沙头角,入境,0,0,0,0
2024-05-23,沙头角,出境,0,0,0,0
2024-05-23,深圳湾,入境,24177,7902,1073,33152
2024-05-23,深圳湾,出境,24324,7640,979,32943
2024-05-23,中国客运码头,入境,634,447,257,1338
2024-05-23,中国客运码头,出境,673,521,281,1475
2024-05-23,港口管制,入境,0,0,49,49
2024-05-23,港口管制,出境,0,0,60,60
2024-05-23,启德邮轮码头,入境,0,0,0,0
2024-05-23,启德邮轮码头,出境,0,0,0,0
2024-05-23,港澳客轮码头,入境,4527,747,1871,7145
2024-05-23,港澳客轮码头,出境,4687,1060,1963,7710
2024-05-24,机场,入境,28826,10039,17565,56430
2024-05-24,机场,出境,34926,7115,13287,55328
2024-05-24,高铁西九龙,入境,12832,19254,1513,33599
2024-05-24,高铁西九龙,出境,20150,11565,1160,32875
2024-05-24,红磡,入境,0,0,0,0
2024-05-24,红磡,出境,0,0,0,0
2024-05-24,罗湖,入境,57083,12002,713,69798
2024-05-24,罗湖,出境,67614,12610,733,80957
2024-05-24,落马洲支线,入境,46437,11563,434,58434
2024-05-24,落马洲支线,出境,57659,10612,312,68583
2024-05-24,香园围,入境,22753,6848,131,29732
2024-05-24,香园围,出境,26272,2628,258,29158
2024-05-24,港珠澳大桥,入境,17059,5241,3804,26104
2024-05-24,港珠澳大桥,出境,24520,10850,3166,38536
2024-05-24,落马洲,入境,9812,2270,527,12609
2024-05-24,落马洲,出境,10383,4045,386,14814
2024-05-24,文锦渡,入境,1433,260,10,1703
2024-05-24,文锦渡,出境,1663,213,12,1888
2024-05-24,沙头角,入境,0,0,0,0
2024-05-24,沙头角,出境,0,0,0,0
2024-05-24,深圳湾,入境,24963,10179,1296,36438
2024-05-24,深圳湾,出境,31696,8643,833,41172
2024-05-24,中国客运码头,入境,741,652,333,1726
2024-05-24,中国客运码头,出境,1181,578,290,2049
2024-05-24,港口管制,入境,2,1,129,132
2024-05-24,港口管制,出境,0,4,52,56
2024-05-24,启德邮轮码头,入境,0,0,0,0
2024-05-24,启德邮轮码头,出境,0,0,0,0
2024-05-24,港澳客轮码头,入境,4878,925,2463,8266
2024-05-24,港澳客轮码头,出境,6053,1062,2561,9676
2024-05-25,机场,入境,29868,8790,17356,56014
2024-05-25,机场,出境,31987,7090,15130,54207
2024-05-25,高铁西九龙,入境,13295,28216,1523,43034
2024-05-25,高铁西九龙,出境,21534,16964,1325,39823
2024-05-25,红磡,入境,0,0,0,0
2024-05-25,红磡,出境,0,0,0,0
2024-05-25,罗湖,入境,71879,16666,761,89306
2024-05-25,罗湖,出境,96507,19339,749,116595
2024-05-25,落马洲支线,入境,60560,20170,477,81207
2024-05-25,落马洲支线,出境,85273,16538,418,102229
2024-05-25,香园围,入境,30477,8129,139,38745
2024-05-25,香园围,出境,39236,4408,133,43777
2024-05-25,港珠澳大桥,入境,21565,7069,5725,34359
2024-05-25,港珠澳大桥,出境,36597,9300,4950,50847
2024-05-25,落马洲,入境,15033,2647,588,18268
2024-05-25,落马洲,出境,15929,8272,420,24621
2024-05-25,文锦渡,入境,981,369,17,1367
2024-05-25,文锦渡,出境,1823,295,6,2124
2024-05-25,沙头角,入境,0,0,0,0
2024-05-25,沙头角,出境,0,0,0,0
2024-05-25,深圳湾,入境,32681,15222,1124,49027
2024-05-25,深圳湾,出境,45811,12786,985,59582
2024-05-25,中国客运码头,入境,806,757,255,1818
2024-05-25,中国客运码头,出境,1122,576,246,1944
2024-05-25,港口管制,入境,1,0,38,39
2024-05-25,港口管制,出境,2,5,70,77
2024-05-25,启德邮轮码头,入境,0,0,0,0
2024-05-25,启德邮轮码头,出境,0,0,0,0
2024-05-25,港澳客轮码头,入境,5278,1146,2736,9160
2024-05-25,港澳客轮码头,出境,7539,1141,2518,11198
2024-05-26,机场,入境,37690,8725,15843,62258
2024-05-26,机场,出境,30678,9114,20152,59944
2024-05-26,高铁西九龙,入境,24714,17406,1301,43421
2024-05-26,高铁西九龙,出境,12379,22729,1410,36518
2024-05-26,红磡,入境,0,0,0,0
2024-05-26,红磡,出境,0,0,0,0
2024-05-26,罗湖,入境,100838,13976,700,115514
2024-05-26,罗湖,出境,68785,18807,676,88268
2024-05-26,落马洲支线,入境,79298,16785,392,96475
2024-05-26,落马洲支线,出境,60444,15931,395,76770
2024-05-26,香园围,入境,41134,7941,137,49212
2024-05-26,香园围,出境,32840,4992,220,38052
2024-05-26,港珠澳大桥,入境,40690,6996,4791,52477
2024-05-26,港珠澳大桥,出境,22452,9891,5394,37737
2024-05-26,落马洲,入境,24341,2489,289,27119
2024-05-26,落马洲,出境,11819,8644,491,20954
2024-05-26,文锦渡,入境,1586,355,5,1946
2024-05-26,文锦渡,出境,1003,298,7,1308
2024-05-26,沙头角,入境,0,0,0,0
2024-05-26,沙头角,出境,0,0,0,0
2024-05-26,深圳湾,入境,53714,11528,913,66155
2024-05-26,深圳湾,出境,34331,14543,1066,49940
2024-05-26,中国客运码头,入境,1350,512,221,2083
2024-05-26,中国客运码头,出境,616,852,309,1777
2024-05-26,港口管制,入境,0,6,23,29
2024-05-26,港口管制,出境,2,1,40,43
2024-05-26,启德邮轮码头,入境,0,0,0,0
2024-05-26,启德邮轮码头,出境,0,0,0,0
2024-05-26,港澳客轮码头,入境,7817,900,1792,10509
2024-05-26,港澳客轮码头,出境,4519,1159,2492,8170
2024-05-27,机场,入境,31815,8848,16056,56719
2024-05-27,机场,出境,29286,7507,16110,52903
2024-05-27,高铁西九龙,入境,14598,11433,1199,27230
2024-05-27,高铁西九龙,出境,11647,12833,1308,25788
2024-05-27,红磡,入境,0,0,0,0
2024-05-27,红磡,出境,0,0,0,0
2024-05-27,罗湖,入境,63085,10191,671,73947
2024-05-27,罗湖,出境,57910,11156,737,69803
2024-05-27,落马洲支线,入境,50523,10103,325,60951
2024-05-27,落马洲支线,出境,49183,9456,342,58981
2024-05-27,香园围,入境,25076,5653,84,30813
2024-05-27,香园围,出境,24372,2798,113,27283
2024-05-27,港珠澳大桥,入境,20474,4246,3413,28133
2024-05-27,港珠澳大桥,出境,16789,8173,3137,28099
2024-05-27,落马洲,入境,12416,2624,301,15341
2024-05-27,落马洲,出境,8490,5879,457,14826
2024-05-27,文锦渡,入境,1552,287,9,1848
2024-05-27,文锦渡,出境,1576,295,22,1893
2024-05-27,沙头角,入境,0,0,0,0
2024-05-27,沙头角,出境,0,0,0,0
2024-05-27,深圳湾,入境,27611,7990,873,36474
2024-05-27,深圳湾,出境,25154,8371,1078,34603
2024-05-27,中国客运码头,入境,662,440,205,1307
2024-05-27,中国客运码头,出境,801,581,203,1585
2024-05-27,港口管制,入境,1,2,37,40
2024-05-27,港口管制,出境,1,0,66,67
2024-05-27,启德邮轮码头,入境,0,0,0,0
2024-05-27,启德邮轮码头,出境,1,0,73,74
2024-05-27,港澳客轮码头,入境,5394,648,1747,7789
2024-05-27,港澳客轮码头,出境,4708,1084,2357,8149
2024-05-28,机场,入境,28133,7095,12715,47943
2024-05-28,机场,出境,24871,6343,14226,45440
2024-05-28,高铁西九龙,入境,11342,10423,1273,23038
2024-05-28,高铁西九龙,出境,10979,10085,1209,22273
2024-05-28,红磡,入境,0,0,0,0
2024-05-28,红磡,出境,0,0,0,0
2024-05-28,罗湖,入境,58151,9918,655,68724
2024-05-28,罗湖,出境,56464,10937,687,68088
2024-05-28,落马洲支线,入境,47039,9992,325,57356
2024-05-28,落马洲支线,出境,48740,10447,345,59532
2024-05-28,香园围,入境,24112,6018,272,30402
2024-05-28,香园围,出境,24465,2771,124,27360
2024-05-28,港珠澳大桥,入境,16715,4148,2922,23785
2024-05-28,港珠澳大桥,出境,16525,7572,3453,27550
2024-05-28,落马洲,入境,9384,1953,308,11645
2024-05-28,落马洲,出境,8167,2436,368,10971
2024-05-28,文锦渡,入境,1418,318,7,1743
2024-05-28,文锦渡,出境,1571,263,5,1839
2024-05-28,沙头角,入境,0,0,0,0
2024-05-28,沙头角,出境,0,0,0,0
2024-05-28,深圳湾,入境,25371,7833,770,33974
2024-05-28,深圳湾,出境,23760,7600,1029,32389
2024-05-28,中国客运码头,入境,606,474,207,1287
2024-05-28,中国客运码头,出境,637,449,302,1388
2024-05-28,港口管制,入境,0,0,11,11
2024-05-28,港口管制,出境,0,0,17,17
2024-05-28,启德邮轮码头,入境,0,0,0,0
2024-05-28,启德邮轮码头,出境,0,0,0,0
2024-05-28,港澳客轮码头,入境,4555,741,1856,7152
2024-05-28,港澳客轮码头,出境,4256,951,1961,7168
2024-05-29,机场,入境,26791,6925,13271,46987
2024-05-29,机场,出境,25663,6060,13228,44951
2024-05-29,高铁西九龙,入境,11568,10984,1168,23720
2024-05-29,高铁西九龙,出境,11640,10395,1195,23230
2024-05-29,红磡,入境,0,0,0,0
2024-05-29,红磡,出境,0,0,0,0
2024-05-29,罗湖,入境,58560,10320,608,69488
2024-05-29,罗湖,出境,57545,11488,675,69708
2024-05-29,落马洲支线,入境,48540,11132,334,60006
2024-05-29,落马洲支线,出境,50238,10487,331,61056
2024-05-29,香园围,入境,26137,6404,125,32666
2024-05-29,香园围,出境,26885,2613,126,29624
2024-05-29,港珠澳大桥,入境,16486,3946,3433,23865
2024-05-29,港珠澳大桥,出境,16614,8248,3332,28194
2024-05-29,落马洲,入境,10059,1929,351,12339
2024-05-29,落马洲,出境,8504,2874,384,11762
2024-05-29,文锦渡,入境,1494,438,2,1934
2024-05-29,文锦渡,出境,1562,287,5,1854
2024-05-29,沙头角,入境,0,0,0,0
2024-05-29,沙头角,出境,0,0,0,0
2024-05-29,深圳湾,入境,24987,7985,871,33843
2024-05-29,深圳湾,出境,24592,7505,1067,33164
2024-05-29,中国客运码头,入境,522,514,165,1201
2024-05-29,中国客运码头,出境,650,581,343,1574
2024-05-29,港口管制,入境,0,0,20,20
2024-05-29,港口管制,出境,0,0,13,13
2024-05-29,启德邮轮码头,入境,0,0,0,0
2024-05-29,启德邮轮码头,出境,0,0,0,0
2024-05-29,港澳客轮码头,入境,4702,698,2148,7548
2024-05-29,港澳客轮码头,出境,4443,1054,2558,8055
2024-05-30,机场,入境,25423,7842,14043,47308
2024-05-30,机场,出境,28364,6134,15303,49801
2024-05-30,高铁西九龙,入境,11026,11114,1269,23409
2024-05-30,高铁西九龙,出境,11667,10449,1116,23232
2024-05-30,红磡,入境,0,0,0,0
2024-05-30,红磡,出境,0,0,0,0
2024-05-30,罗湖,入境,58389,10138,631,69158
2024-05-30,罗湖,出境,58463,11456,703,70622
2024-05-30,落马洲支线,入境,48590,10330,390,59310
2024-05-30,落马洲支线,出境,50793,10361,358,61512
2024-05-30,香园围,入境,26281,4886,122,31289
2024-05-30,香园围,出境,27034,3162,97,30293
2024-05-30,港珠澳大桥,入境,16831,4335,3539,24705
2024-05-30,港珠澳大桥,出境,17727,8047,3082,28856
2024-05-30,落马洲,入境,10042,1907,351,12300
2024-05-30,落马洲,出境,8187,2513,360,11060
2024-05-30,文锦渡,入境,1481,385,8,1874
2024-05-30,文锦渡,出境,1620,343,19,1982
2024-05-30,沙头角,入境,0,0,0,0
2024-05-30,沙头角,出境,0,0,0,0
2024-05-30,深圳湾,入境,24798,8019,959,33776
2024-05-30,深圳湾,出境,25339,8223,894,34456
2024-05-30,中国客运码头,入境,645,489,231,1365
2024-05-30,中国客运码头,出境,672,526,241,1439
2024-05-30,港口管制,入境,0,0,46,46
2024-05-30,港口管制,出境,0,0,63,63
2024-05-30,启德邮轮码头,入境,0,0,0,0
2024-05-30,启德邮轮码头,出境,0,0,0,0
2024-05-30,港澳客轮码头,入境,4537,653,1849,7039
2024-05-30,港澳客轮码头,出境,4696,930,1887,7513
2024-05-31,机场,入境,28825,9582,16385,54792
2024-05-31,机场,出境,32398,6897,15115,54410
2024-05-31,高铁西九龙,入境,12659,13247,1467,27373
2024-05-31,高铁西九龙,出境,19070,10414,1164,30648
2024-05-31,红磡,入境,0,0,0,0
2024-05-31,红磡,出境,0,0,0,0
2024-05-31,罗湖,入境,55871,10357,766,66994
2024-05-31,罗湖,出境,65953,11459,698,78110
2024-05-31,落马洲支线,入境,45817,10759,380,56956
2024-05-31,落马洲支线,出境,55975,10755,377,67107
2024-05-31,香园围,入境,22350,4302,104,26756
2024-05-31,香园围,出境,25590,2969,178,28737
2024-05-31,港珠澳大桥,入境,16675,4294,4018,24987
2024-05-31,港珠澳大桥,出境,22686,6920,3073,32679
2024-05-31,落马洲,入境,9753,2035,480,12268
2024-05-31,落马洲,出境,9979,2658,320,12957
2024-05-31,文锦渡,入境,1401,313,12,1726
2024-05-31,文锦渡,出境,1689,290,15,1994
2024-05-31,沙头角,入境,0,0,0,0
2024-05-31,沙头角,出境,0,0,0,0
2024-05-31,深圳湾,入境,24676,9133,1210,35019
2024-05-31,深圳湾,出境,30495,8984,828,40307
2024-05-31,中国客运码头,入境,646,440,195,1281
2024-05-31,中国客运码头,出境,811,486,132,1429
2024-05-31,港口管制,入境,0,0,43,43
2024-05-31,港口管制,出境,34,0,36,70
2024-05-31,启德邮轮码头,入境,0,0,0,0
2024-05-31,启德邮轮码头,出境,0,0,0,0
2024-05-31,港澳客轮码头,入境,4448,668,2029,7145
2024-05-31,港澳客轮码头,出境,5163,890,1978,8031
2024-06-01,机场,入境,28534,7760,17986,54280
2024-06-01,机场,出境,32486,6484,14357,53327
2024-06-01,高铁西九龙,入境,11793,22155,1331,35279
2024-06-01,高铁西九龙,出境,19331,14536,1070,34937
2024-06-01,红磡,入境,0,0,0,0
2024-06-01,红磡,出境,0,0,0,0
2024-06-01,罗湖,入境,63550,13492,715,77757
2024-06-01,罗湖,出境,84614,14694,745,100053
2024-06-01,落马洲支线,入境,51772,16308,399,68479
2024-06-01,落马洲支线,出境,72250,14518,390,87158
2024-06-01,香园围,入境,25253,5660,123,31036
2024-06-01,香园围,出境,31550,3475,141,35166
2024-06-01,港珠澳大桥,入境,17802,5600,5374,28776
2024-06-01,港珠澳大桥,出境,29137,6957,4398,40492
2024-06-01,落马洲,入境,12921,2295,407,15623
2024-06-01,落马洲,出境,13761,3613,365,17739
2024-06-01,文锦渡,入境,942,334,8,1284
2024-06-01,文锦渡,出境,1419,305,17,1741
2024-06-01,沙头角,入境,0,0,0,0
2024-06-01,沙头角,出境,0,0,0,0
2024-06-01,深圳湾,入境,26977,12350,1257,40584
2024-06-01,深圳湾,出境,37832,11240,1016,50088
2024-06-01,中国客运码头,入境,387,414,95,896
2024-06-01,中国客运码头,出境,714,256,116,1086
2024-06-01,港口管制,入境,3,0,20,23
2024-06-01,港口管制,出境,0,0,22,22
2024-06-01,启德邮轮码头,入境,0,0,0,0
2024-06-01,启德邮轮码头,出境,0,0,0,0
2024-06-01,港澳客轮码头,入境,3852,622,1747,6221
2024-06-01,港澳客轮码头,出境,5872,902,1860,8634
2024-06-02,机场,入境,38370,7788,14218,60376
2024-06-02,机场,出境,28049,9886,18038,55973
2024-06-02,高铁西九龙,入境,22758,12602,1057,36417
2024-06-02,高铁西九龙,出境,11270,18768,1348,31386
2024-06-02,红磡,入境,0,0,0,0
2024-06-02,红磡,出境,0,0,0,0
2024-06-02,罗湖,入境,94441,11960,695,107096
2024-06-02,罗湖,出境,64713,15486,716,80915
2024-06-02,落马洲支线,入境,73051,14204,404,87659
2024-06-02,落马洲支线,出境,56211,14486,428,71125
2024-06-02,香园围,入境,37427,6138,151,43716
2024-06-02,香园围,出境,30292,4179,190,34661
2024-06-02,港珠澳大桥,入境,35753,5712,4473,45938
2024-06-02,港珠澳大桥,出境,21351,7520,5276,34147
2024-06-02,落马洲,入境,21695,2146,278,24119
2024-06-02,落马洲,出境,11119,4955,385,16459
2024-06-02,文锦渡,入境,1418,356,16,1790
2024-06-02,文锦渡,出境,942,296,16,1254
2024-06-02,沙头角,入境,0,0,0,0
2024-06-02,沙头角,出境,0,0,0,0
2024-06-02,深圳湾,入境,48805,10088,917,59810
2024-06-02,深圳湾,出境,31920,11628,1306,44854
2024-06-02,中国客运码头,入境,1106,298,62,1466
2024-06-02,中国客运码头,出境,464,540,114,1118
2024-06-02,港口管制,入境,34,0,31,65
2024-06-02,港口管制,出境,0,0,12,12
2024-06-02,启德邮轮码头,入境,0,0,0,0
2024-06-02,启德邮轮码头,出境,0,0,0,0
2024-06-02,港澳客轮码头,入境,7575,635,1613,9823
2024-06-02,港澳客轮码头,出境,4668,916,2291,7875
2024-06-03,机场,入境,30535,7388,13857,51780
2024-06-03,机场,出境,26873,6974,16855,50702
2024-06-03,高铁西九龙,入境,13136,10949,1059,25144
2024-06-03,高铁西九龙,出境,11119,9728,1221,22068
2024-06-03,红磡,入境,0,0,0,0
2024-06-03,红磡,出境,0,0,0,0
2024-06-03,罗湖,入境,59269,10225,561,70055
2024-06-03,罗湖,出境,54637,10387,555,65579
2024-06-03,落马洲支线,入境,46487,9667,297,56451
2024-06-03,落马洲支线,出境,45896,8740,329,54965
2024-06-03,香园围,入境,22681,4197,93,26971
2024-06-03,香园围,出境,22809,2456,192,25457
2024-06-03,港珠澳大桥,入境,18535,3979,3252,25766
2024-06-03,港珠澳大桥,出境,16372,6147,3316,25835
2024-06-03,落马洲,入境,11659,2411,277,14347
2024-06-03,落马洲,出境,8040,2768,425,11233
2024-06-03,文锦渡,入境,1437,258,20,1715
2024-06-03,文锦渡,出境,1450,220,11,1681
2024-06-03,沙头角,入境,0,0,0,0
2024-06-03,沙头角,出境,0,0,0,0
2024-06-03,深圳湾,入境,24151,7811,773,32735
2024-06-03,深圳湾,出境,22132,6911,1147,30190
2024-06-03,中国客运码头,入境,553,377,79,1009
2024-06-03,中国客运码头,出境,590,276,129,995
2024-06-03,港口管制,入境,0,0,71,71
2024-06-03,港口管制,出境,1,0,37,38
2024-06-03,启德邮轮码头,入境,0,0,0,0
2024-06-03,启德邮轮码头,出境,0,0,0,0
2024-06-03,港澳客轮码头,入境,5010,674,1678,7362
2024-06-03,港澳客轮码头,出境,4246,861,2180,7287
2024-06-04,机场,入境,26321,6165,11615,44101
2024-06-04,机场,出境,23778,5717,13429,42924
2024-06-04,高铁西九龙,入境,10456,9690,909,21055
2024-06-04,高铁西九龙,出境,10564,9334,1000,20898
2024-06-04,红磡,入境,0,0,0,0
2024-06-04,红磡,出境,0,0,0,0
2024-06-04,罗湖,入境,56100,9577,541,66218
2024-06-04,罗湖,出境,55456,10202,604,66262
2024-06-04,落马洲支线,入境,45825,9823,280,55928
2024-06-04,落马洲支线,出境,47384,9627,312,57323
2024-06-04,香园围,入境,24577,4244,139,28960
2024-06-04,香园围,出境,25150,2460,127,27737
2024-06-04,港珠澳大桥,入境,15807,4339,2907,23053
2024-06-04,港珠澳大桥,出境,15616,6143,3004,24763
2024-06-04,落马洲,入境,9354,1877,306,11537
2024-06-04,落马洲,出境,8200,2162,419,10781
2024-06-04,文锦渡,入境,1527,329,19,1875
2024-06-04,文锦渡,出境,1628,310,11,1949
2024-06-04,沙头角,入境,0,0,0,0
2024-06-04,沙头角,出境,0,0,0,0
2024-06-04,深圳湾,入境,23334,7424,736,31494
2024-06-04,深圳湾,出境,23050,7209,969,31228
2024-06-04,中国客运码头,入境,466,355,74,895
2024-06-04,中国客运码头,出境,538,375,97,1010
2024-06-04,港口管制,入境,0,0,47,47
2024-06-04,港口管制,出境,0,0,38,38
2024-06-04,启德邮轮码头,入境,0,0,0,0
2024-06-04,启德邮轮码头,出境,0,0,0,0
2024-06-04,港澳客轮码头,入境,4246,583,1390,6219
2024-06-04,港澳客轮码头,出境,4051,967,1815,6833
2024-06-05,机场,入境,24625,6934,14784,46343
2024-06-05,机场,出境,29277,6192,12460,47929
2024-06-05,高铁西九龙,入境,10559,10737,1001,22297
2024-06-05,高铁西九龙,出境,11755,9399,1005,22159
2024-06-05,红磡,入境,0,0,0,0
2024-06-05,红磡,出境,0,0,0,0
2024-06-05,罗湖,入境,57338,10046,628,68012
2024-06-05,罗湖,出境,56766,11041,652,68459
2024-06-05,落马洲支线,入境,46939,10412,319,57670
2024-06-05,落马洲支线,出境,49076,10004,300,59380
2024-06-05,香园围,入境,24880,4326,140,29346
2024-06-05,香园围,出境,25152,2888,112,28152
2024-06-05,港珠澳大桥,入境,15662,3884,3799,23345
2024-06-05,港珠澳大桥,出境,16213,6074,3983,26270
2024-06-05,落马洲,入境,9754,1957,287,11998
2024-06-05,落马洲,出境,8180,2347,398,10925
2024-06-05,文锦渡,入境,1445,343,11,1799
2024-06-05,文锦渡,出境,1522,312,11,1845
2024-06-05,沙头角,入境,0,0,0,0
2024-06-05,沙头角,出境,0,0,0,0
2024-06-05,深圳湾,入境,24159,7872,770,32801
2024-06-05,深圳湾,出境,24363,7284,887,32534
2024-06-05,中国客运码头,入境,480,427,67,974
2024-06-05,中国客运码头,出境,480,336,113,929
2024-06-05,港口管制,入境,1,0,27,28
2024-06-05,港口管制,出境,90,0,33,123
2024-06-05,启德邮轮码头,入境,0,0,0,0
2024-06-05,启德邮轮码头,出境,0,0,0,0
2024-06-05,港澳客轮码头,入境,4416,743,1774,6933
2024-06-05,港澳客轮码头,出境,4111,1039,2143,7293
2024-06-06,机场,入境,24393,8383,18006,50782
2024-06-06,机场,出境,36905,7327,12246,56478
2024-06-06,高铁西九龙,入境,10910,14009,1244,26163
2024-06-06,高铁西九龙,出境,13557,10414,1165,25136
2024-06-06,红磡,入境,0,0,0,0
2024-06-06,红磡,出境,0,0,0,0
2024-06-06,罗湖,入境,56694,10588,595,67877
2024-06-06,罗湖,出境,57959,11301,630,69890
2024-06-06,落马洲支线,入境,47234,11068,332,58634
2024-06-06,落马洲支线,出境,50231,10341,304,60876
2024-06-06,香园围,入境,24808,3961,107,28876
2024-06-06,香园围,出境,26263,2957,217,29437
2024-06-06,港珠澳大桥,入境,16482,4703,3599,24784
2024-06-06,港珠澳大桥,出境,18342,6386,3357,28085
2024-06-06,落马洲,入境,10070,2453,384,12907
2024-06-06,落马洲,出境,8549,2452,307,11308
2024-06-06,文锦渡,入境,1430,342,10,1782
2024-06-06,文锦渡,出境,1593,318,6,1917
2024-06-06,沙头角,入境,0,0,0,0
2024-06-06,沙头角,出境,0,0,0,0
2024-06-06,深圳湾,入境,24122,9647,1001,34770
2024-06-06,深圳湾,出境,25848,8089,932,34869
2024-06-06,中国客运码头,入境,571,497,130,1198
2024-06-06,中国客运码头,出境,582,412,143,1137
2024-06-06,港口管制,入境,0,0,83,83
2024-06-06,港口管制,出境,42,0,26,68
2024-06-06,启德邮轮码头,入境,0,0,0,0
2024-06-06,启德邮轮码头,出境,0,0,0,0
2024-06-06,港澳客轮码头,入境,4542,753,2034,7329
2024-06-06,港澳客轮码头,出境,4807,1033,2401,8241
2024-06-07,机场,入境,25621,12017,18802,56440
2024-06-07,机场,出境,47451,8160,12338,67949
2024-06-07,高铁西九龙,入境,12310,17834,1454,31598
2024-06-07,高铁西九龙,出境,27316,11548,1096,39960
2024-06-07,红磡,入境,0,0,0,0
2024-06-07,红磡,出境,0,0,0,0
2024-06-07,罗湖,入境,61794,12333,696,74823
2024-06-07,罗湖,出境,85124,13995,785,99904
2024-06-07,落马洲支线,入境,50480,12996,428,63904
2024-06-07,落马洲支线,出境,68007,11968,388,80363
2024-06-07,香园围,入境,26919,4572,149,31640
2024-06-07,香园围,出境,33401,3209,231,36841
2024-06-07,港珠澳大桥,入境,18216,5047,4580,27843
2024-06-07,港珠澳大桥,出境,36675,7157,3332,47164
2024-06-07,落马洲,入境,10627,2797,532,13956
2024-06-07,落马洲,出境,11950,2787,344,15081
2024-06-07,文锦渡,入境,1434,381,11,1826
2024-06-07,文锦渡,出境,1890,411,8,2309
2024-06-07,沙头角,入境,0,0,0,0
2024-06-07,沙头角,出境,0,0,0,0
2024-06-07,深圳湾,入境,27214,11371,1218,39803
2024-06-07,深圳湾,出境,41641,10093,896,52630
2024-06-07,中国客运码头,入境,623,538,166,1327
2024-06-07,中国客运码头,出境,1592,579,141,2312
2024-06-07,港口管制,入境,3,2,51,56
2024-06-07,港口管制,出境,43,0,15,58
2024-06-07,启德邮轮码头,入境,0,0,0,0
2024-06-07,启德邮轮码头,出境,0,0,0,0
2024-06-07,港澳客轮码头,入境,5316,962,3098,9376
2024-06-07,港澳客轮码头,出境,7687,1249,3213,12149
2024-06-08,机场,入境,27577,11963,19996,59536
2024-06-08,机场,出境,42180,7645,14708,64533
2024-06-08,高铁西九龙,入境,11496,36665,1531,49692
2024-06-08,高铁西九龙,出境,38841,19269,1174,59284
2024-06-08,红磡,入境,0,0,0,0
2024-06-08,红磡,出境,0,0,0,0
2024-06-08,罗湖,入境,67929,21533,857,90319
2024-06-08,罗湖,出境,129550,23790,937,154277
2024-06-08,落马洲支线,入境,57211,26033,490,83734
2024-06-08,落马洲支线,出境,102287,21636,480,124403
2024-06-08,香园围,入境,29246,8108,179,37533
2024-06-08,香园围,出境,44885,5026,152,50063
2024-06-08,港珠澳大桥,入境,22031,7681,5792,35504
2024-06-08,港珠澳大桥,出境,61621,9313,4616,75550
2024-06-08,落马洲,入境,15127,3354,491,18972
2024-06-08,落马洲,出境,19927,5185,433,25545
2024-06-08,文锦渡,入境,924,562,6,1492
2024-06-08,文锦渡,出境,2002,463,17,2482
2024-06-08,沙头角,入境,0,0,0,0
2024-06-08,沙头角,出境,0,0,0,0
2024-06-08,深圳湾,入境,31165,17746,1241,50152
2024-06-08,深圳湾,出境,66657,14161,1056,81874
2024-06-08,中国客运码头,入境,660,1204,198,2062
2024-06-08,中国客运码头,出境,3011,667,173,3851
2024-06-08,港口管制,入境,0,0,31,31
2024-06-08,港口管制,出境,2,1,63,66
2024-06-08,启德邮轮码头,入境,0,0,0,0
2024-06-08,启德邮轮码头,出境,0,0,0,0
2024-06-08,港澳客轮码头,入境,5919,1538,3280,10737
2024-06-08,港澳客轮码头,出境,10796,1670,2807,15273
2024-06-09,机场,入境,32291,7891,13514,53696
2024-06-09,机场,出境,29885,7792,19369,57046
2024-06-09,高铁西九龙,入境,17897,29627,1210,48734
2024-06-09,高铁西九龙,出境,22317,26001,1425,49743
2024-06-09,红磡,入境,0,0,0,0
2024-06-09,红磡,出境,0,0,0,0
2024-06-09,罗湖,入境,95853,18903,785,115541
2024-06-09,罗湖,出境,103453,27871,782,132106
2024-06-09,落马洲支线,入境,77564,25068,490,103122
2024-06-09,落马洲支线,出境,96314,24971,479,121764
2024-06-09,香园围,入境,35244,7393,160,42797
2024-06-09,香园围,出境,38873,4890,238,44001
2024-06-09,港珠澳大桥,入境,37448,8169,5968,51585
2024-06-09,港珠澳大桥,出境,47284,10215,5851,63350
2024-06-09,落马洲,入境,22955,2614,335,25904
2024-06-09,落马洲,出境,17321,5914,517,23752
2024-06-09,文锦渡,入境,1054,340,8,1402
2024-06-09,文锦渡,出境,1122,284,6,1412
2024-06-09,沙头角,入境,0,0,0,0
2024-06-09,沙头角,出境,0,0,0,0
2024-06-09,深圳湾,入境,45889,13899,908,60696
2024-06-09,深圳湾,出境,51842,15893,1124,68859
2024-06-09,中国客运码头,入境,761,931,91,1783
2024-06-09,中国客运码头,出境,1328,792,124,2244
2024-06-09,港口管制,入境,0,0,31,31
2024-06-09,港口管制,出境,0,0,27,27
2024-06-09,启德邮轮码头,入境,0,0,0,0
2024-06-09,启德邮轮码头,出境,0,0,0,0
2024-06-09,港澳客轮码头,入境,7742,1620,2371,11733
2024-06-09,港澳客轮码头,出境,8979,2268,2634,13881
2024-06-10,机场,入境,52062,9185,12798,74045
2024-06-10,机场,出境,26297,10783,20146,57226
2024-06-10,高铁西九龙,入境,37634,13962,896,52492
2024-06-10,高铁西九龙,出境,10428,30173,1628,42229
2024-06-10,红磡,入境,0,0,0,0
2024-06-10,红磡,出境,0,0,0,0
2024-06-10,罗湖,入境,130349,13076,652,144077
2024-06-10,罗湖,出境,52769,19547,654,72970
2024-06-10,落马洲支线,入境,97418,16010,416,113844
2024-06-10,落马洲支线,出境,48021,18123,477,66621
2024-06-10,香园围,入境,47947,5522,178,53647
2024-06-10,香园围,出境,26730,3737,91,30558
2024-06-10,港珠澳大桥,入境,73958,5762,4131,83851
2024-06-10,港珠澳大桥,出境,22283,8344,5072,35699
2024-06-10,落马洲,入境,32393,2109,248,34750
2024-06-10,落马洲,出境,10184,4526,557,15267
2024-06-10,文锦渡,入境,2086,454,5,2545
2024-06-10,文锦渡,出境,945,365,6,1316
2024-06-10,沙头角,入境,0,0,0,0
2024-06-10,沙头角,出境,0,0,0,0
2024-06-10,深圳湾,入境,78954,10390,842,90186
2024-06-10,深圳湾,出境,26623,15917,1376,43916
2024-06-10,中国客运码头,入境,3164,401,106,3671
2024-06-10,中国客运码头,出境,472,820,196,1488
2024-06-10,港口管制,入境,0,0,19,19
2024-06-10,港口管制,出境,0,0,39,39
2024-06-10,启德邮轮码头,入境,0,0,0,0
2024-06-10,启德邮轮码头,出境,0,0,0,0
2024-06-10,港澳客轮码头,入境,13162,997,1837,15996
2024-06-10,港澳客轮码头,出境,4886,1518,2446,8850
2024-06-11,机场,入境,38029,10109,13613,61751
2024-06-11,机场,出境,26338,8317,14171,48826
2024-06-11,高铁西九龙,入境,20181,12005,980,33166
2024-06-11,高铁西九龙,出境,12462,10718,1296,24476
2024-06-11,红磡,入境,0,0,0,0
2024-06-11,红磡,出境,0,0,0,0
2024-06-11,罗湖,入境,71226,10635,630,82491
2024-06-11,罗湖,出境,58891,10492,716,70099
2024-06-11,落马洲支线,入境,53754,9925,328,64007
2024-06-11,落马洲支线,出境,51040,9900,390,61330
2024-06-11,香园围,入境,26171,3891,86,30148
2024-06-11,香园围,出境,25153,2323,208,27684
2024-06-11,港珠澳大桥,入境,32600,4866,3306,40772
2024-06-11,港珠澳大桥,出境,18358,6046,3448,27852
2024-06-11,落马洲,入境,17346,2559,316,20221
2024-06-11,落马洲,出境,8764,3098,541,12403
2024-06-11,文锦渡,入境,1562,318,16,1896
2024-06-11,文锦渡,出境,1558,266,14,1838
2024-06-11,沙头角,入境,0,0,0,0
2024-06-11,沙头角,出境,0,0,0,0
2024-06-11,深圳湾,入境,31519,8665,882,41066
2024-06-11,深圳湾,出境,25637,8850,1338,35825
2024-06-11,中国客运码头,入境,1002,405,99,1506
2024-06-11,中国客运码头,出境,611,281,102,994
2024-06-11,港口管制,入境,4,0,14,18
2024-06-11,港口管制,出境,0,0,24,24
2024-06-11,启德邮轮码头,入境,0,0,0,0
2024-06-11,启德邮轮码头,出境,0,0,0,0
2024-06-11,港澳客轮码头,入境,5567,716,1524,7807
2024-06-11,港澳客轮码头,出境,4870,919,2000,7789
2024-06-12,机场,入境,31631,9508,15679,56818
2024-06-12,机场,出境,27020,6279,12696,45995
2024-06-12,高铁西九龙,入境,13115,12112,1004,26231
2024-06-12,高铁西九龙,出境,11994,9925,1204,23123
2024-06-12,红磡,入境,0,0,0,0
2024-06-12,红磡,出境,0,0,0,0
2024-06-12,罗湖,入境,61046,10964,573,72583
2024-06-12,罗湖,出境,58248,11494,694,70436
2024-06-12,落马洲支线,入境,48919,11017,318,60254
2024-06-12,落马洲支线,出境,50583,10369,385,61337
2024-06-12,香园围,入境,25133,5676,88,30897
2024-06-12,香园围,出境,25622,2695,133,28450
2024-06-12,港珠澳大桥,入境,17856,4810,3318,25984
2024-06-12,港珠澳大桥,出境,17673,6365,3357,27395
2024-06-12,落马洲,入境,10474,2179,314,12967
2024-06-12,落马洲,出境,8672,2704,489,11865
2024-06-12,文锦渡,入境,1386,329,15,1730
2024-06-12,文锦渡,出境,1491,307,9,1807
2024-06-12,沙头角,入境,0,0,0,0
2024-06-12,沙头角,出境,0,0,0,0
2024-06-12,深圳湾,入境,26104,8414,860,35378
2024-06-12,深圳湾,出境,24778,7859,1036,33673
2024-06-12,中国客运码头,入境,608,518,109,1235
2024-06-12,中国客运码头,出境,693,370,167,1230
2024-06-12,港口管制,入境,43,0,37,80
2024-06-12,港口管制,出境,3,0,81,84
2024-06-12,启德邮轮码头,入境,0,0,0,0
2024-06-12,启德邮轮码头,出境,0,0,0,0
2024-06-12,港澳客轮码头,入境,4863,742,2019,7624
2024-06-12,港澳客轮码头,出境,4717,961,2270,7948
2024-06-13,机场,入境,25933,8503,16331,50767
2024-06-13,机场,出境,29720,6190,11873,47783
2024-06-13,高铁西九龙,入境,12570,12672,1096,26338
2024-06-13,高铁西九龙,出境,12167,10523,1159,23849
2024-06-13,红磡,入境,0,0,0,0
2024-06-13,红磡,出境,0,0,0,0
2024-06-13,罗湖,入境,60531,10692,578,71801
2024-06-13,罗湖,出境,58268,11553,600,70421
2024-06-13,落马洲支线,入境,48317,10758,339,59414
2024-06-13,落马洲支线,出境,49614,10209,308,60131
2024-06-13,香园围,入境,24715,7085,109,31909
2024-06-13,香园围,出境,25530,2792,116,28438
2024-06-13,港珠澳大桥,入境,18161,5439,3535,27135
2024-06-13,港珠澳大桥,出境,18263,8416,3398,30077
2024-06-13,落马洲,入境,10298,2043,311,12652
2024-06-13,落马洲,出境,8673,2465,420,11558
2024-06-13,文锦渡,入境,1475,333,21,1829
2024-06-13,文锦渡,出境,1652,342,6,2000
2024-06-13,沙头角,入境,0,0,0,0
2024-06-13,沙头角,出境,0,0,0,0
2024-06-13,深圳湾,入境,25413,8515,893,34821
2024-06-13,深圳湾,出境,25204,7927,1000,34131
2024-06-13,中国客运码头,入境,669,630,153,1452
2024-06-13,中国客运码头,出境,561,495,110,1166
2024-06-13,港口管制,入境,0,0,28,28
2024-06-13,港口管制,出境,0,0,17,17
2024-06-13,启德邮轮码头,入境,0,0,0,0
2024-06-13,启德邮轮码头,出境,0,0,0,0
2024-06-13,港澳客轮码头,入境,5145,916,1967,8028
2024-06-13,港澳客轮码头,出境,4905,1252,2201,8358
2024-06-14,机场,入境,27505,10579,19037,57121
2024-06-14,机场,出境,36007,7447,13517,56971
2024-06-14,高铁西九龙,入境,12871,14574,1336,28781
2024-06-14,高铁西九龙,出境,19011,12122,1289,32422
2024-06-14,红磡,入境,0,0,0,0
2024-06-14,红磡,出境,0,0,0,0
2024-06-14,罗湖,入境,57283,10761,737,68781
2024-06-14,罗湖,出境,66444,12358,804,79606
2024-06-14,落马洲支线,入境,45865,11114,415,57394
2024-06-14,落马洲支线,出境,56226,11199,373,67798
2024-06-14,香园围,入境,21467,4858,142,26467
2024-06-14,香园围,出境,24485,3146,291,27922
2024-06-14,港珠澳大桥,入境,17418,5038,4319,26775
2024-06-14,港珠澳大桥,出境,25573,8645,3707,37925
2024-06-14,落马洲,入境,10500,2036,458,12994
2024-06-14,落马洲,出境,10534,2824,396,13754
2024-06-14,文锦渡,入境,1430,298,11,1739
2024-06-14,文锦渡,出境,1782,292,5,2079
2024-06-14,沙头角,入境,0,0,0,0
2024-06-14,沙头角,出境,0,0,0,0
2024-06-14,深圳湾,入境,25510,8892,1212,35614
2024-06-14,深圳湾,出境,30861,9123,830,40814
2024-06-14,中国客运码头,入境,707,572,175,1454
2024-06-14,中国客运码头,出境,902,642,178,1722
2024-06-14,港口管制,入境,1,0,40,41
2024-06-14,港口管制,出境,9,0,60,69
2024-06-14,启德邮轮码头,入境,0,0,0,0
2024-06-14,启德邮轮码头,出境,0,0,0,0
2024-06-14,港澳客轮码头,入境,4958,895,2516,8369
2024-06-14,港澳客轮码头,出境,6695,1188,2107,9990
2024-06-15,机场,入境,30219,9748,18686,58653
2024-06-15,机场,出境,33081,7085,14656,54822
2024-06-15,高铁西九龙,入境,13312,23849,1442,38603
2024-06-15,高铁西九龙,出境,21176,15555,1367,38098
2024-06-15,红磡,入境,0,0,0,0
2024-06-15,红磡,出境,0,0,0,0
2024-06-15,罗湖,入境,67117,15104,717,82938
2024-06-15,罗湖,出境,87610,16149,733,104492
2024-06-15,落马洲支线,入境,57407,17182,400,74989
2024-06-15,落马洲支线,出境,78332,14839,376,93547
2024-06-15,香园围,入境,26805,7670,136,34611
2024-06-15,香园围,出境,34776,5111,178,40065
2024-06-15,港珠澳大桥,入境,21946,6875,5210,34031
2024-06-15,港珠澳大桥,出境,36244,8521,4764,49529
2024-06-15,落马洲,入境,14557,2563,400,17520
2024-06-15,落马洲,出境,14733,3885,430,19048
2024-06-15,文锦渡,入境,913,323,23,1259
2024-06-15,文锦渡,出境,1539,277,15,1831
2024-06-15,沙头角,入境,0,0,0,0
2024-06-15,沙头角,出境,0,0,0,0
2024-06-15,深圳湾,入境,28789,12519,1136,42444
2024-06-15,深圳湾,出境,39908,10943,998,51849
2024-06-15,中国客运码头,入境,565,602,138,1305
2024-06-15,中国客运码头,出境,947,485,139,1571
2024-06-15,港口管制,入境,4,7,29,40
2024-06-15,港口管制,出境,13,0,24,37
2024-06-15,启德邮轮码头,入境,0,0,0,0
2024-06-15,启德邮轮码头,出境,0,0,0,0
2024-06-15,港澳客轮码头,入境,5616,820,2614,9050
2024-06-15,港澳客轮码头,出境,7455,985,2481,10921
2024-06-16,机场,入境,39182,9351,16049,64582
2024-06-16,机场,出境,29917,8940,18477,57334
2024-06-16,高铁西九龙,入境,23075,13970,1043,38088
2024-06-16,高铁西九龙,出境,12480,17921,1411,31812
2024-06-16,红磡,入境,0,0,0,0
2024-06-16,红磡,出境,0,0,0,0
2024-06-16,罗湖,入境,96132,11298,769,108199
2024-06-16,罗湖,出境,67308,14790,804,82902
2024-06-16,落马洲支线,入境,79854,13690,393,93937
2024-06-16,落马洲支线,出境,61352,13333,427,75112
2024-06-16,香园围,入境,42088,7334,142,49564
2024-06-16,香园围,出境,33639,3948,230,37817
2024-06-16,港珠澳大桥,入境,41723,5587,4518,51828
2024-06-16,港珠澳大桥,出境,22855,8831,5227,36913
2024-06-16,落马洲,入境,22383,1978,340,24701
2024-06-16,落马洲,出境,12200,7007,655,19862
2024-06-16,文锦渡,入境,1854,282,5,2141
2024-06-16,文锦渡,出境,1062,283,10,1355
2024-06-16,沙头角,入境,0,0,0,0
2024-06-16,沙头角,出境,0,0,0,0
2024-06-16,深圳湾,入境,53381,8879,910,63170
2024-06-16,深圳湾,出境,34768,11722,1313,47803
2024-06-16,中国客运码头,入境,1123,347,111,1581
2024-06-16,中国客运码头,出境,529,560,156,1245
2024-06-16,港口管制,入境,0,0,40,40
2024-06-16,港口管制,出境,1,0,37,38
2024-06-16,启德邮轮码头,入境,0,0,0,0
2024-06-16,启德邮轮码头,出境,0,0,0,0
2024-06-16,港澳客轮码头,入境,8292,729,1807,10828
2024-06-16,港澳客轮码头,出境,5093,1118,2623,8834
2024-06-17,机场,入境,29479,9686,16036,55201
2024-06-17,机场,出境,30113,8999,18175,57287
2024-06-17,高铁西九龙,入境,14553,13045,1135,28733
2024-06-17,高铁西九龙,出境,12920,13064,1342,27326
2024-06-17,红磡,入境,0,0,0,0
2024-06-17,红磡,出境,0,0,0,0
2024-06-17,罗湖,入境,64867,11323,741,76931
2024-06-17,罗湖,出境,61383,12053,753,74189
2024-06-17,落马洲支线,入境,51981,11345,332,63658
2024-06-17,落马洲支线,出境,52180,10354,391,62925
2024-06-17,香园围,入境,25946,5593,200,31739
2024-06-17,香园围,出境,25915,2717,211,28843
2024-06-17,港珠澳大桥,入境,21106,4696,3974,29776
2024-06-17,港珠澳大桥,出境,18472,7944,3941,30357
2024-06-17,落马洲,入境,11896,2558,307,14761
2024-06-17,落马洲,出境,9059,2904,540,12503
2024-06-17,文锦渡,入境,1692,327,9,2028
2024-06-17,文锦渡,出境,1740,301,16,2057
2024-06-17,沙头角,入境,0,0,0,0
2024-06-17,沙头角,出境,0,0,0,0
2024-06-17,深圳湾,入境,27993,9091,918,38002
2024-06-17,深圳湾,出境,27207,8938,1313,37458
2024-06-17,中国客运码头,入境,623,495,119,1237
2024-06-17,中国客运码头,出境,671,615,140,1426
2024-06-17,港口管制,入境,0,0,30,30
2024-06-17,港口管制,出境,10,9,32,51
2024-06-17,启德邮轮码头,入境,0,0,0,0
2024-06-17,启德邮轮码头,出境,0,0,0,0
2024-06-17,港澳客轮码头,入境,5854,726,2197,8777
2024-06-17,港澳客轮码头,出境,4981,1055,2418,8454
2024-06-18,机场,入境,33890,8612,15262,57764
2024-06-18,机场,出境,27450,7183,16064,50697
2024-06-18,高铁西九龙,入境,11968,12592,1157,25717
2024-06-18,高铁西九龙,出境,12046,11747,1287,25080
2024-06-18,红磡,入境,0,0,0,0
2024-06-18,红磡,出境,0,0,0,0
2024-06-18,罗湖,入境,60105,10616,621,71342
2024-06-18,罗湖,出境,59594,11537,687,71818
2024-06-18,落马洲支线,入境,48262,11039,306,59607
2024-06-18,落马洲支线,出境,50464,10634,351,61449
2024-06-18,香园围,入境,25283,5181,101,30565
2024-06-18,香园围,出境,25968,2775,178,28921
2024-06-18,港珠澳大桥,入境,17974,4583,3536,26093
2024-06-18,港珠澳大桥,出境,18134,7435,3463,29032
2024-06-18,落马洲,入境,10205,2022,272,12499
2024-06-18,落马洲,出境,8917,2762,489,12168
2024-06-18,文锦渡,入境,1549,321,5,1875
2024-06-18,文锦渡,出境,1616,253,11,1880
2024-06-18,沙头角,入境,0,0,0,0
2024-06-18,沙头角,出境,0,0,0,0
2024-06-18,深圳湾,入境,25929,8895,878,35702
2024-06-18,深圳湾,出境,25745,8375,1093,35213
2024-06-18,中国客运码头,入境,538,480,118,1136
2024-06-18,中国客运码头,出境,602,429,116,1147
2024-06-18,港口管制,入境,0,0,16,16
2024-06-18,港口管制,出境,0,0,30,30
2024-06-18,启德邮轮码头,入境,0,0,0,0
2024-06-18,启德邮轮码头,出境,0,0,0,0
2024-06-18,港澳客轮码头,入境,4852,742,2104,7698
2024-06-18,港澳客轮码头,出境,4685,1125,2242,8052
2024-06-19,机场,入境,26715,9326,16730,52771
2024-06-19,机场,出境,30212,6603,14266,51081
2024-06-19,高铁西九龙,入境,11586,12486,1243,25315
2024-06-19,高铁西九龙,出境,12303,11699,1293,25295
2024-06-19,红磡,入境,0,0,0,0
2024-06-19,红磡,出境,0,0,0,0
2024-06-19,罗湖,入境,61289,10652,678,72619
2024-06-19,罗湖,出境,60219,11589,743,72551
2024-06-19,落马洲支线,入境,49997,10771,351,61119
2024-06-19,落马洲支线,出境,51460,10762,342,62564
2024-06-19,香园围,入境,25620,6915,168,32703
2024-06-19,香园围,出境,26086,2461,101,28648
2024-06-19,港珠澳大桥,入境,18171,4665,3946,26782
2024-06-19,港珠澳大桥,出境,18645,8514,3972,31131
2024-06-19,落马洲,入境,10522,2157,343,13022
2024-06-19,落马洲,出境,8866,2850,404,12120
2024-06-19,文锦渡,入境,1564,300,19,1883
2024-06-19,文锦渡,出境,1629,260,16,1905
2024-06-19,沙头角,入境,0,0,0,0
2024-06-19,沙头角,出境,0,0,0,0
2024-06-19,深圳湾,入境,26066,8295,969,35330
2024-06-19,深圳湾,出境,25075,7716,963,33754
2024-06-19,中国客运码头,入境,498,443,166,1107
2024-06-19,中国客运码头,出境,578,460,170,1208
2024-06-19,港口管制,入境,2,0,15,17
2024-06-19,港口管制,出境,2,0,16,18
2024-06-19,启德邮轮码头,入境,0,0,0,0
2024-06-19,启德邮轮码头,出境,0,0,0,0
2024-06-19,港澳客轮码头,入境,4919,787,2264,7970
2024-06-19,港澳客轮码头,出境,4852,1345,2732,8929
2024-06-20,机场,入境,26162,8907,16659,51728
2024-06-20,机场,出境,34145,7079,13878,55102
2024-06-20,高铁西九龙,入境,11737,13725,1314,26776
2024-06-20,高铁西九龙,出境,12902,12005,1128,26035
2024-06-20,红磡,入境,0,0,0,0
2024-06-20,红磡,出境,0,0,0,0
2024-06-20,罗湖,入境,59329,10900,668,70897
2024-06-20,罗湖,出境,59065,12040,735,71840
2024-06-20,落马洲支线,入境,48319,11156,399,59874
2024-06-20,落马洲支线,出境,50464,10749,376,61589
2024-06-20,香园围,入境,25539,5638,170,31347
2024-06-20,香园围,出境,26541,3028,179,29748
2024-06-20,港珠澳大桥,入境,17951,4929,3574,26454
2024-06-20,港珠澳大桥,出境,19172,9647,3369,32188
2024-06-20,落马洲,入境,10604,2119,412,13135
2024-06-20,落马洲,出境,8793,2445,418,11656
2024-06-20,文锦渡,入境,1545,370,29,1944
2024-06-20,文锦渡,出境,1575,288,22,1885
2024-06-20,沙头角,入境,0,0,0,0
2024-06-20,沙头角,出境,0,0,0,0
2024-06-20,深圳湾,入境,25031,8907,1061,34999
2024-06-20,深圳湾,出境,24892,8204,1004,34100
2024-06-20,中国客运码头,入境,541,517,177,1235
2024-06-20,中国客运码头,出境,677,483,139,1299
2024-06-20,港口管制,入境,83,0,18,101
2024-06-20,港口管制,出境,3,0,15,18
2024-06-20,启德邮轮码头,入境,0,0,0,0
2024-06-20,启德邮轮码头,出境,0,0,0,0
2024-06-20,港澳客轮码头,入境,4924,817,1892,7633
2024-06-20,港澳客轮码头,出境,4994,1228,1926,8148
2024-06-21,机场,入境,29651,9713,18095,57459
2024-06-21,机场,出境,38637,8164,15385,62186
2024-06-21,高铁西九龙,入境,13430,15242,1390,30062
2024-06-21,高铁西九龙,出境,20243,13154,1154,34551
2024-06-21,红磡,入境,0,0,0,0
2024-06-21,红磡,出境,0,0,0,0
2024-06-21,罗湖,入境,62717,11812,674,75203
2024-06-21,罗湖,出境,74196,13606,691,88493
2024-06-21,落马洲支线,入境,51398,12502,429,64329
2024-06-21,落马洲支线,出境,64972,12379,388,77739
2024-06-21,香园围,入境,26250,7192,112,33554
2024-06-21,香园围,出境,31128,3522,216,34866
2024-06-21,港珠澳大桥,入境,19571,5345,4420,29336
2024-06-21,港珠澳大桥,出境,28953,9062,3986,42001
2024-06-21,落马洲,入境,11055,2239,520,13814
2024-06-21,落马洲,出境,11278,2804,469,14551
2024-06-21,文锦渡,入境,1448,365,21,1834
2024-06-21,文锦渡,出境,1876,328,10,2214
2024-06-21,沙头角,入境,0,0,0,0
2024-06-21,沙头角,出境,0,0,0,0
2024-06-21,深圳湾,入境,27035,10088,1291,38414
2024-06-21,深圳湾,出境,34674,10216,992,45882
2024-06-21,中国客运码头,入境,787,531,116,1434
2024-06-21,中国客运码头,出境,900,557,113,1570
2024-06-21,港口管制,入境,0,0,55,55
2024-06-21,港口管制,出境,0,0,33,33
2024-06-21,启德邮轮码头,入境,0,0,0,0
2024-06-21,启德邮轮码头,出境,0,0,0,0
2024-06-21,港澳客轮码头,入境,5537,990,2382,8909
2024-06-21,港澳客轮码头,出境,7023,1329,2369,10721
2024-06-22,机场,入境,30719,10055,17525,58299
2024-06-22,机场,出境,35059,7733,16086,58878
2024-06-22,高铁西九龙,入境,14471,25899,1365,41735
2024-06-22,高铁西九龙,出境,22626,20027,1232,43885
2024-06-22,红磡,入境,0,0,0,0
2024-06-22,红磡,出境,0,0,0,0
2024-06-22,罗湖,入境,78583,17072,738,96393
2024-06-22,罗湖,出境,104438,20565,715,125718
2024-06-22,落马洲支线,入境,67253,22734,490,90477
2024-06-22,落马洲支线,出境,94663,20645,468,115776
2024-06-22,香园围,入境,33100,7967,226,41293
2024-06-22,香园围,出境,43592,5239,198,49029
2024-06-22,港珠澳大桥,入境,25185,7162,5824,38171
2024-06-22,港珠澳大桥,出境,42387,9818,5472,57677
2024-06-22,落马洲,入境,17239,2598,464,20301
2024-06-22,落马洲,出境,17476,4116,430,22022
2024-06-22,文锦渡,入境,1185,446,11,1642
2024-06-22,文锦渡,出境,1764,341,13,2118
2024-06-22,沙头角,入境,0,0,0,0
2024-06-22,沙头角,出境,0,0,0,0
2024-06-22,深圳湾,入境,35632,14322,1193,51147
2024-06-22,深圳湾,出境,49751,13279,1126,64156
2024-06-22,中国客运码头,入境,704,744,113,1561
2024-06-22,中国客运码头,出境,969,579,120,1668
2024-06-22,港口管制,入境,0,0,46,46
2024-06-22,港口管制,出境,1,0,15,16
2024-06-22,启德邮轮码头,入境,1,2,178,181
2024-06-22,启德邮轮码头,出境,0,0,0,0
2024-06-22,港澳客轮码头,入境,6131,1154,2651,9936
2024-06-22,港澳客轮码头,出境,8759,1491,2638,12888
2024-06-23,机场,入境,39249,9611,15636,64496
2024-06-23,机场,出境,31952,9009,20508,61469
2024-06-23,高铁西九龙,入境,23898,16509,1130,41537
2024-06-23,高铁西九龙,出境,12807,20939,1394,35140
2024-06-23,红磡,入境,0,0,0,0
2024-06-23,红磡,出境,0,0,0,0
2024-06-23,罗湖,入境,110231,14090,707,125028
2024-06-23,罗湖,出境,73937,18466,745,93148
2024-06-23,落马洲支线,入境,89637,17011,412,107060
2024-06-23,落马洲支线,出境,66822,17012,405,84239
2024-06-23,香园围,入境,43697,9382,124,53203
2024-06-23,香园围,出境,34251,5151,268,39670
2024-06-23,港珠澳大桥,入境,46748,7100,5100,58948
2024-06-23,港珠澳大桥,出境,25117,9755,5934,40806
2024-06-23,落马洲,入境,26575,2215,419,29209
2024-06-23,落马洲,出境,12821,3531,562,16914
2024-06-23,文锦渡,入境,1643,325,13,1981
2024-06-23,文锦渡,出境,1116,290,7,1413
2024-06-23,沙头角,入境,0,0,0,0
2024-06-23,沙头角,出境,0,0,0,0
2024-06-23,深圳湾,入境,57087,10737,975,68799
2024-06-23,深圳湾,出境,35754,13089,1309,50152
2024-06-23,中国客运码头,入境,1162,607,105,1874
2024-06-23,中国客运码头,出境,528,620,141,1289
2024-06-23,港口管制,入境,0,2,37,39
2024-06-23,港口管制,出境,0,0,33,33
2024-06-23,启德邮轮码头,入境,0,0,0,0
2024-06-23,启德邮轮码头,出境,0,0,0,0
2024-06-23,港澳客轮码头,入境,9245,1191,1925,12361
2024-06-23,港澳客轮码头,出境,5741,1562,2723,10026
2024-06-24,机场,入境,34946,10523,16595,62064
2024-06-24,机场,出境,31393,7822,17782,56997
2024-06-24,高铁西九龙,入境,15212,13886,1182,30280
2024-06-24,高铁西九龙,出境,13297,12027,1309,26633
2024-06-24,红磡,入境,0,0,0,0
2024-06-24,红磡,出境,0,0,0,0
2024-06-24,罗湖,入境,65250,11546,728,77524
2024-06-24,罗湖,出境,59477,11950,759,72186
2024-06-24,落马洲支线,入境,52246,11427,340,64013
2024-06-24,落马洲支线,出境,50690,10308,404,61402
2024-06-24,香园围,入境,26600,6184,159,32943
2024-06-24,香园围,出境,26192,2722,161,29075
2024-06-24,港珠澳大桥,入境,23343,4909,3752,32004
2024-06-24,港珠澳大桥,出境,18872,9621,3843,32336
2024-06-24,落马洲,入境,12989,2512,334,15835
2024-06-24,落马洲,出境,8736,3062,548,12346
2024-06-24,文锦渡,入境,1610,326,6,1942
2024-06-24,文锦渡,出境,1561,285,8,1854
2024-06-24,沙头角,入境,0,0,0,0
2024-06-24,沙头角,出境,0,0,0,0
2024-06-24,深圳湾,入境,28126,8687,819,37632
2024-06-24,深圳湾,出境,25788,8696,1250,35734
2024-06-24,中国客运码头,入境,625,451,104,1180
2024-06-24,中国客运码头,出境,700,543,178,1421
2024-06-24,港口管制,入境,13,0,25,38
2024-06-24,港口管制,出境,0,0,28,28
2024-06-24,启德邮轮码头,入境,0,0,0,0
2024-06-24,启德邮轮码头,出境,0,0,0,0
2024-06-24,港澳客轮码头,入境,6190,867,2218,9275
2024-06-24,港澳客轮码头,出境,4861,1314,2588,8763
2024-06-25,机场,入境,30831,9312,14458,54601
2024-06-25,机场,出境,31189,7839,15332,54360
2024-06-25,高铁西九龙,入境,12290,12905,1114,26309
2024-06-25,高铁西九龙,出境,11988,11050,1194,24232
2024-06-25,红磡,入境,0,0,0,0
2024-06-25,红磡,出境,0,0,0,0
2024-06-25,罗湖,入境,59649,10233,542,70424
2024-06-25,罗湖,出境,58732,11635,673,71040
2024-06-25,落马洲支线,入境,48009,11568,337,59914
2024-06-25,落马洲支线,出境,49715,10419,327,60461
2024-06-25,香园围,入境,24309,6407,139,30855
2024-06-25,香园围,出境,24996,2734,240,27970
2024-06-25,港珠澳大桥,入境,18687,4916,3575,27178
2024-06-25,港珠澳大桥,出境,18432,8998,3525,30955
2024-06-25,落马洲,入境,10225,2162,299,12686
2024-06-25,落马洲,出境,8792,2490,436,11718
2024-06-25,文锦渡,入境,1552,304,5,1861
2024-06-25,文锦渡,出境,1693,272,6,1971
2024-06-25,沙头角,入境,0,0,0,0
2024-06-25,沙头角,出境,0,0,0,0
2024-06-25,深圳湾,入境,26240,8817,886,35943
2024-06-25,深圳湾,出境,24918,8712,1042,34672
2024-06-25,中国客运码头,入境,483,438,111,1032
2024-06-25,中国客运码头,出境,589,433,126,1148
2024-06-25,港口管制,入境,3,0,24,27
2024-06-25,港口管制,出境,13,0,18,31
2024-06-25,启德邮轮码头,入境,0,0,0,0
2024-06-25,启德邮轮码头,出境,2,3,198,203
2024-06-25,港澳客轮码头,入境,4995,927,2202,8124
2024-06-25,港澳客轮码头,出境,4806,1375,2217,8398
2024-06-26,机场,入境,29555,9926,14788,54269
2024-06-26,机场,出境,35440,7479,15278,58197
2024-06-26,高铁西九龙,入境,12802,14459,1120,28381
2024-06-26,高铁西九龙,出境,12913,12089,1304,26306
2024-06-26,红磡,入境,0,0,0,0
2024-06-26,红磡,出境,0,0,0,0
2024-06-26,罗湖,入境,59216,10537,545,70298
2024-06-26,罗湖,出境,58737,11755,613,71105
2024-06-26,落马洲支线,入境,48711,11729,373,60813
2024-06-26,落马洲支线,出境,50329,11068,358,61755
2024-06-26,香园围,入境,25021,6364,153,31538
2024-06-26,香园围,出境,25821,2790,158,28769
2024-06-26,港珠澳大桥,入境,17186,5063,4134,26383
2024-06-26,港珠澳大桥,出境,17641,8993,4090,30724
2024-06-26,落马洲,入境,10287,2315,320,12922
2024-06-26,落马洲,出境,8606,2817,405,11828
2024-06-26,文锦渡,入境,1618,366,7,1991
2024-06-26,文锦渡,出境,1731,285,6,2022
2024-06-26,沙头角,入境,0,0,0,0
2024-06-26,沙头角,出境,0,0,0,0
2024-06-26,深圳湾,入境,25850,9366,1073,36289
2024-06-26,深圳湾,出境,25342,8764,1053,35159
2024-06-26,中国客运码头,入境,521,510,95,1126
2024-06-26,中国客运码头,出境,633,441,113,1187
2024-06-26,港口管制,入境,0,0,74,74
2024-06-26,港口管制,出境,25,0,34,59
2024-06-26,启德邮轮码头,入境,0,0,0,0
2024-06-26,启德邮轮码头,出境,0,0,0,0
2024-06-26,港澳客轮码头,入境,4752,892,2043,7687
2024-06-26,港澳客轮码头,出境,4649,1535,2297,8481
2024-06-27,机场,入境,29098,10271,15717,55086
2024-06-27,机场,出境,44686,6837,14544,66067
2024-06-27,高铁西九龙,入境,12427,15219,1189,28835
2024-06-27,高铁西九龙,出境,15548,13297,1245,30090
2024-06-27,红磡,入境,0,0,0,0
2024-06-27,红磡,出境,0,0,0,0
2024-06-27,罗湖,入境,59125,10645,648,70418
2024-06-27,罗湖,出境,60317,12527,695,73539
2024-06-27,落马洲支线,入境,48714,11536,384,60634
2024-06-27,落马洲支线,出境,51848,11711,407,63966
2024-06-27,香园围,入境,25385,5332,146,30863
2024-06-27,香园围,出境,26548,2695,187,29430
2024-06-27,港珠澳大桥,入境,17994,5188,3725,26907
2024-06-27,港珠澳大桥,出境,20854,9359,3850,34063
2024-06-27,落马洲,入境,10418,2098,388,12904
2024-06-27,落马洲,出境,8851,2844,381,12076
2024-06-27,文锦渡,入境,1571,408,7,1986
2024-06-27,文锦渡,出境,1663,313,4,1980
2024-06-27,沙头角,入境,0,0,0,0
2024-06-27,沙头角,出境,0,0,0,0
2024-06-27,深圳湾,入境,25025,9423,1020,35468
2024-06-27,深圳湾,出境,26677,9563,1055,37295
2024-06-27,中国客运码头,入境,537,473,127,1137
2024-06-27,中国客运码头,出境,789,531,206,1526
2024-06-27,港口管制,入境,27,0,12,39
2024-06-27,港口管制,出境,72,0,32,104
2024-06-27,启德邮轮码头,入境,0,0,0,0
2024-06-27,启德邮轮码头,出境,0,0,0,0
2024-06-27,港澳客轮码头,入境,4764,1079,1965,7808
2024-06-27,港澳客轮码头,出境,5326,1528,2155,9009
2024-06-28,机场,入境,31807,10836,17168,59811
2024-06-28,机场,出境,53422,6775,13518,73715
2024-06-28,高铁西九龙,入境,14368,15766,1349,31483
2024-06-28,高铁西九龙,出境,30979,14212,1285,46476
2024-06-28,红磡,入境,0,0,0,0
2024-06-28,红磡,出境,0,0,0,0
2024-06-28,罗湖,入境,61730,11640,651,74021
2024-06-28,罗湖,出境,80972,14152,786,95910
2024-06-28,落马洲支线,入境,50212,12478,464,63154
2024-06-28,落马洲支线,出境,69003,12460,375,81838
2024-06-28,香园围,入境,25749,4943,183,30875
2024-06-28,香园围,出境,30923,3318,208,34449
2024-06-28,港珠澳大桥,入境,20538,5463,4684,30685
2024-06-28,港珠澳大桥,出境,38283,9227,4236,51746
2024-06-28,落马洲,入境,10956,2344,557,13857
2024-06-28,落马洲,出境,11987,3354,380,15721
2024-06-28,文锦渡,入境,1511,477,15,2003
2024-06-28,文锦渡,出境,1977,415,9,2401
2024-06-28,沙头角,入境,0,0,0,0
2024-06-28,沙头角,出境,0,0,0,0
2024-06-28,深圳湾,入境,27693,9854,1208,38755
2024-06-28,深圳湾,出境,41651,10439,989,53079
2024-06-28,中国客运码头,入境,731,550,164,1445
2024-06-28,中国客运码头,出境,1336,559,172,2067
2024-06-28,港口管制,入境,1,3,62,66
2024-06-28,港口管制,出境,95,1,34,130
2024-06-28,启德邮轮码头,入境,0,0,0,0
2024-06-28,启德邮轮码头,出境,0,0,0,0
2024-06-28,港澳客轮码头,入境,5761,1278,2453,9492
2024-06-28,港澳客轮码头,出境,8070,1657,2351,12078
2024-06-29,机场,入境,34015,10749,17557,62321
2024-06-29,机场,出境,50763,6773,15107,72643
2024-06-29,高铁西九龙,入境,12967,26869,1343,41179
2024-06-29,高铁西九龙,出境,47427,19939,1312,68678
2024-06-29,红磡,入境,0,0,0,0
2024-06-29,红磡,出境,0,0,0,0
2024-06-29,罗湖,入境,67791,15606,755,84152
2024-06-29,罗湖,出境,126166,19419,764,146349
2024-06-29,落马洲支线,入境,56478,20457,463,77398
2024-06-29,落马洲支线,出境,108827,19739,449,129015
2024-06-29,香园围,入境,27727,8151,154,36032
2024-06-29,香园围,出境,44996,4700,170,49866
2024-06-29,港珠澳大桥,入境,23138,6887,5632,35657
2024-06-29,港珠澳大桥,出境,67124,10125,5281,82530
2024-06-29,落马洲,入境,15254,2596,419,18269
2024-06-29,落马洲,出境,20371,4728,485,25584
2024-06-29,文锦渡,入境,1089,456,11,1556
2024-06-29,文锦渡,出境,2327,385,11,2723
2024-06-29,沙头角,入境,0,0,0,0
2024-06-29,沙头角,出境,0,0,0,0
2024-06-29,深圳湾,入境,30879,13684,1133,45696
2024-06-29,深圳湾,出境,68898,13607,1118,83623
2024-06-29,中国客运码头,入境,530,732,127,1389
2024-06-29,中国客运码头,出境,3298,563,131,3992
2024-06-29,港口管制,入境,9,1,49,59
2024-06-29,港口管制,出境,1,0,65,66
2024-06-29,启德邮轮码头,入境,0,0,0,0
2024-06-29,启德邮轮码头,出境,0,0,0,0
2024-06-29,港澳客轮码头,入境,6440,1357,2503,10300
2024-06-29,港澳客轮码头,出境,13313,1677,2439,17429
2024-06-30,机场,入境,40289,10224,13847,64360
2024-06-30,机场,出境,38106,9741,19469,67316
2024-06-30,高铁西九龙,入境,19487,16903,1341,37731
2024-06-30,高铁西九龙,出境,26386,21053,1464,48903
2024-06-30,红磡,入境,0,0,0,0
2024-06-30,红磡,出境,0,0,0,0
2024-06-30,罗湖,入境,104054,12207,634,116895
2024-06-30,罗湖,出境,113719,16834,714,131267
2024-06-30,落马洲支线,入境,84738,15420,382,100540
2024-06-30,落马洲支线,出境,109008,17022,495,126525
2024-06-30,香园围,入境,37731,7691,206,45628
2024-06-30,香园围,出境,47036,4168,211,51415
2024-06-30,港珠澳大桥,入境,40944,6725,5321,52990
2024-06-30,港珠澳大桥,出境,55480,9631,6028,71139
2024-06-30,落马洲,入境,24609,1945,352,26906
2024-06-30,落马洲,出境,19110,3626,471,23207
2024-06-30,文锦渡,入境,1158,320,4,1482
2024-06-30,文锦渡,出境,1656,330,10,1996
2024-06-30,沙头角,入境,0,0,0,0
2024-06-30,沙头角,出境,0,0,0,0
2024-06-30,深圳湾,入境,51597,9426,907,61930
2024-06-30,深圳湾,出境,60290,11946,1205,73441
2024-06-30,中国客运码头,入境,841,475,98,1414
2024-06-30,中国客运码头,出境,1365,520,113,1998
2024-06-30,港口管制,入境,5,0,81,86
2024-06-30,港口管制,出境,36,1,36,73
2024-06-30,启德邮轮码头,入境,286,3212,107,3605
2024-06-30,启德邮轮码头,出境,285,3192,142,3619
2024-06-30,港澳客轮码头,入境,8549,1052,1796,11397
2024-06-30,港澳客轮码头,出境,11040,1643,2217,14900
2024-07-01,机场,入境,53350,7086,12873,73309
2024-07-01,机场,出境,32099,8142,15627,55868
2024-07-01,高铁西九龙,入境,41495,12186,936,54617
2024-07-01,高铁西九龙,出境,10646,11280,1057,22983
2024-07-01,红磡,入境,0,0,0,0
2024-07-01,红磡,出境,0,0,0,0
2024-07-01,罗湖,入境,142729,12838,730,156297
2024-07-01,罗湖,出境,56070,12002,542,68614
2024-07-01,落马洲支线,入境,117874,12555,390,130819
2024-07-01,落马洲支线,出境,49393,9308,253,58954
2024-07-01,香园围,入境,48603,7622,166,56391
2024-07-01,香园围,出境,23222,3236,151,26609
2024-07-01,港珠澳大桥,入境,86021,8161,3859,98041
2024-07-01,港珠澳大桥,出境,18682,11102,3234,33018
2024-07-01,落马洲,入境,36775,2315,333,39423
2024-07-01,落马洲,出境,9969,2280,389,12638
2024-07-01,文锦渡,入境,2666,330,11,3007
2024-07-01,文锦渡,出境,962,193,6,1161
2024-07-01,沙头角,入境,0,0,0,0
2024-07-01,沙头角,出境,0,0,0,0
2024-07-01,深圳湾,入境,88668,10484,961,100113
2024-07-01,深圳湾,出境,25906,8387,853,35146
2024-07-01,中国客运码头,入境,3573,385,76,4034
2024-07-01,中国客运码头,出境,429,362,110,901
2024-07-01,港口管制,入境,54,3,12,69
2024-07-01,港口管制,出境,0,0,14,14
2024-07-01,启德邮轮码头,入境,0,0,0,0
2024-07-01,启德邮轮码头,出境,0,0,0,0
2024-07-01,港澳客轮码头,入境,15464,959,1540,17963
2024-07-01,港澳客轮码头,出境,4698,1602,2027,8327
2024-07-02,机场,入境,44005,8322,12536,64863
2024-07-02,机场,出境,30306,8043,13808,52157
2024-07-02,高铁西九龙,入境,20622,15061,1226,36909
2024-07-02,高铁西九龙,出境,12208,12516,1122,25846
2024-07-02,红磡,入境,0,0,0,0
2024-07-02,红磡,出境,0,0,0,0
2024-07-02,罗湖,入境,64960,12109,663,77732
2024-07-02,罗湖,出境,55684,12513,665,68862
2024-07-02,落马洲支线,入境,51450,11978,356,63784
2024-07-02,落马洲支线,出境,46472,10425,360,57257
2024-07-02,香园围,入境,26064,7109,88,33261
2024-07-02,香园围,出境,24215,2896,106,27217
2024-07-02,港珠澳大桥,入境,24823,5953,3761,34537
2024-07-02,港珠澳大桥,出境,17391,10306,3395,31092
2024-07-02,落马洲,入境,13180,2822,318,16320
2024-07-02,落马洲,出境,8410,2584,349,11343
2024-07-02,文锦渡,入境,1485,383,12,1880
2024-07-02,文锦渡,出境,1443,330,8,1781
2024-07-02,沙头角,入境,0,0,0,0
2024-07-02,沙头角,出境,0,0,0,0
2024-07-02,深圳湾,入境,31018,9807,965,41790
2024-07-02,深圳湾,出境,24490,8358,1043,33891
2024-07-02,中国客运码头,入境,719,471,94,1284
2024-07-02,中国客运码头,出境,504,589,109,1202
2024-07-02,港口管制,入境,12,0,58,70
2024-07-02,港口管制,出境,0,1,28,29
2024-07-02,启德邮轮码头,入境,0,0,0,0
2024-07-02,启德邮轮码头,出境,0,0,37,37
2024-07-02,港澳客轮码头,入境,5950,1174,1779,8903
2024-07-02,港澳客轮码头,出境,4342,1745,1995,8082
2024-07-03,机场,入境,35825,9617,14583,60025
2024-07-03,机场,出境,29140,8518,13328,50986
2024-07-03,高铁西九龙,入境,13232,15143,1060,29435
2024-07-03,高铁西九龙,出境,12301,12557,1225,26083
2024-07-03,红磡,入境,0,0,0,0
2024-07-03,红磡,出境,0,0,0,0
2024-07-03,罗湖,入境,59390,11560,599,71549
2024-07-03,罗湖,出境,57885,12263,628,70776
2024-07-03,落马洲支线,入境,47644,12162,369,60175
2024-07-03,落马洲支线,出境,48593,10914,376,59883
2024-07-03,香园围,入境,25672,5442,151,31265
2024-07-03,香园围,出境,26022,3569,144,29735
2024-07-03,港珠澳大桥,入境,18132,5713,3850,27695
2024-07-03,港珠澳大桥,出境,17736,9804,3539,31079
2024-07-03,落马洲,入境,10438,2133,355,12926
2024-07-03,落马洲,出境,8825,2409,377,11611
2024-07-03,文锦渡,入境,1533,407,11,1951
2024-07-03,文锦渡,出境,1584,337,8,1929
2024-07-03,沙头角,入境,0,0,0,0
2024-07-03,沙头角,出境,0,0,0,0
2024-07-03,深圳湾,入境,26312,8924,977,36213
2024-07-03,深圳湾,出境,25601,8275,923,34799
2024-07-03,中国客运码头,入境,511,472,93,1076
2024-07-03,中国客运码头,出境,470,510,82,1062
2024-07-03,港口管制,入境,2,0,59,61
2024-07-03,港口管制,出境,0,0,42,42
2024-07-03,启德邮轮码头,入境,0,0,0,0
2024-07-03,启德邮轮码头,出境,0,0,0,0
2024-07-03,港澳客轮码头,入境,4796,1226,1865,7887
2024-07-03,港澳客轮码头,出境,4809,1854,2072,8735
2024-07-04,机场,入境,30936,9651,15692,56279
2024-07-04,机场,出境,31790,8371,12826,52987
2024-07-04,高铁西九龙,入境,13105,16221,1285,30611
2024-07-04,高铁西九龙,出境,12447,13686,1314,27447
2024-07-04,红磡,入境,0,0,0,0
2024-07-04,红磡,出境,0,0,0,0
2024-07-04,罗湖,入境,57927,11692,592,70211
2024-07-04,罗湖,出境,56658,12686,726,70070
2024-07-04,落马洲支线,入境,47059,12201,356,59616
2024-07-04,落马洲支线,出境,48935,11332,353,60620
2024-07-04,香园围,入境,24798,6384,156,31338
2024-07-04,香园围,出境,25209,2933,162,28304
2024-07-04,港珠澳大桥,入境,17583,5721,3760,27064
2024-07-04,港珠澳大桥,出境,18133,8861,3966,30960
2024-07-04,落马洲,入境,10438,2144,334,12916
2024-07-04,落马洲,出境,8594,2350,381,11325
2024-07-04,文锦渡,入境,1578,311,19,1908
2024-07-04,文锦渡,出境,1684,270,17,1971
2024-07-04,沙头角,入境,0,0,0,0
2024-07-04,沙头角,出境,0,0,0,0
2024-07-04,深圳湾,入境,25929,9396,1024,36349
2024-07-04,深圳湾,出境,25622,8724,987,35333
2024-07-04,中国客运码头,入境,415,431,132,978
2024-07-04,中国客运码头,出境,499,440,171,1110
2024-07-04,港口管制,入境,3,0,24,27
2024-07-04,港口管制,出境,37,0,57,94
2024-07-04,启德邮轮码头,入境,0,0,0,0
2024-07-04,启德邮轮码头,出境,0,0,0,0
2024-07-04,港澳客轮码头,入境,4548,1230,1895,7673
2024-07-04,港澳客轮码头,出境,4421,1931,1998,8350
2024-07-05,机场,入境,30058,10634,16845,57537
2024-07-05,机场,出境,35143,9772,14328,59243
2024-07-05,高铁西九龙,入境,13274,17287,1326,31887
2024-07-05,高铁西九龙,出境,19158,14702,1209,35069
2024-07-05,红磡,入境,0,0,0,0
2024-07-05,红磡,出境,0,0,0,0
2024-07-05,罗湖,入境,61429,13156,644,75229
2024-07-05,罗湖,出境,71412,14302,635,86349
2024-07-05,落马洲支线,入境,50039,13605,411,64055
2024-07-05,落马洲支线,出境,61197,12841,366,74404
2024-07-05,香园围,入境,26314,5587,181,32082
2024-07-05,香园围,出境,29824,3666,186,33676
2024-07-05,港珠澳大桥,入境,18983,6093,4367,29443
2024-07-05,港珠澳大桥,出境,26684,9532,3983,40199
2024-07-05,落马洲,入境,11327,2487,518,14332
2024-07-05,落马洲,出境,11022,2907,367,14296
2024-07-05,文锦渡,入境,1462,374,11,1847
2024-07-05,文锦渡,出境,1778,355,9,2142
2024-07-05,沙头角,入境,0,0,0,0
2024-07-05,沙头角,出境,0,0,0,0
2024-07-05,深圳湾,入境,27674,10999,1260,39933
2024-07-05,深圳湾,出境,32828,9793,1031,43652
2024-07-05,中国客运码头,入境,541,510,139,1190
2024-07-05,中国客运码头,出境,751,494,156,1401
2024-07-05,港口管制,入境,7,0,20,27
2024-07-05,港口管制,出境,16,0,21,37
2024-07-05,启德邮轮码头,入境,0,0,0,0
2024-07-05,启德邮轮码头,出境,0,0,0,0
2024-07-05,港澳客轮码头,入境,5356,1360,2551,9267
2024-07-05,港澳客轮码头,出境,6516,1988,2414,10918
2024-07-06,机场,入境,33394,10043,14973,58410
2024-07-06,机场,出境,32411,10782,14688,57881
2024-07-06,高铁西九龙,入境,13996,30711,1496,46203
2024-07-06,高铁西九龙,出境,20990,21096,1178,43264
2024-07-06,红磡,入境,0,0,0,0
2024-07-06,红磡,出境,0,0,0,0
2024-07-06,罗湖,入境,71349,19237,747,91333
2024-07-06,罗湖,出境,94576,22077,749,117402
2024-07-06,落马洲支线,入境,58680,24565,524,83769
2024-07-06,落马洲支线,出境,82408,21434,525,104367
2024-07-06,香园围,入境,29206,9108,174,38488
2024-07-06,香园围,出境,36773,5552,316,42641
2024-07-06,港珠澳大桥,入境,23008,8096,5991,37095
2024-07-06,港珠澳大桥,出境,35135,10126,5169,50430
2024-07-06,落马洲,入境,15896,3369,357,19622
2024-07-06,落马洲,出境,16075,4637,349,21061
2024-07-06,文锦渡,入境,1213,504,4,1721
2024-07-06,文锦渡,出境,1753,383,27,2163
2024-07-06,沙头角,入境,0,0,0,0
2024-07-06,沙头角,出境,0,0,0,0
2024-07-06,深圳湾,入境,33945,17168,1193,52306
2024-07-06,深圳湾,出境,46035,14413,1144,61592
2024-07-06,中国客运码头,入境,488,669,98,1255
2024-07-06,中国客运码头,出境,815,505,133,1453
2024-07-06,港口管制,入境,40,3,37,80
2024-07-06,港口管制,出境,0,0,26,26
2024-07-06,启德邮轮码头,入境,0,0,0,0
2024-07-06,启德邮轮码头,出境,0,0,0,0
2024-07-06,港澳客轮码头,入境,5779,1509,2672,9960
2024-07-06,港澳客轮码头,出境,7087,1852,2584,11523
2024-07-07,机场,入境,41160,9656,13525,64341
2024-07-07,机场,出境,29537,12416,18461,60414
2024-07-07,高铁西九龙,入境,22415,21958,1339,45712
2024-07-07,高铁西九龙,出境,12491,23320,1452,37263
2024-07-07,红磡,入境,0,0,0,0
2024-07-07,红磡,出境,0,0,0,0
2024-07-07,罗湖,入境,102509,15799,852,119160
2024-07-07,罗湖,出境,71865,19395,833,92093
2024-07-07,落马洲支线,入境,81134,18451,455,100040
2024-07-07,落马洲支线,出境,64430,18045,428,82903
2024-07-07,香园围,入境,41020,9031,128,50179
2024-07-07,香园围,出境,33581,4967,199,38747
2024-07-07,港珠澳大桥,入境,40674,7179,5974,53827
2024-07-07,港珠澳大桥,出境,24814,9854,6042,40710
2024-07-07,落马洲,入境,24646,2715,381,27742
2024-07-07,落马洲,出境,12410,4104,459,16973
2024-07-07,文锦渡,入境,1738,467,14,2219
2024-07-07,文锦渡,出境,1172,302,14,1488
2024-07-07,沙头角,入境,0,0,0,0
2024-07-07,沙头角,出境,0,0,0,0
2024-07-07,深圳湾,入境,53549,13020,1011,67580
2024-07-07,深圳湾,出境,35212,13540,1241,49993
2024-07-07,中国客运码头,入境,1034,548,97,1679
2024-07-07,中国客运码头,出境,394,609,133,1136
2024-07-07,港口管制,入境,0,0,67,67
2024-07-07,港口管制,出境,1,0,8,9
2024-07-07,启德邮轮码头,入境,97,3266,80,3443
2024-07-07,启德邮轮码头,出境,94,3252,83,3429
2024-07-07,港澳客轮码头,入境,7957,1409,2052,11418
2024-07-07,港澳客轮码头,出境,5579,1999,2570,10148
2024-07-08,机场,入境,34875,10936,14208,60019
2024-07-08,机场,出境,28156,10700,15072,53928
2024-07-08,高铁西九龙,入境,14768,20171,1270,36209
2024-07-08,高铁西九龙,出境,12942,15330,1327,29599
2024-07-08,红磡,入境,0,0,0,0
2024-07-08,红磡,出境,0,0,0,0
2024-07-08,罗湖,入境,66523,15188,659,82370
2024-07-08,罗湖,出境,60733,14727,717,76177
2024-07-08,落马洲支线,入境,52656,14707,319,67682
2024-07-08,落马洲支线,出境,50702,12146,395,63243
2024-07-08,香园围,入境,26447,7077,203,33727
2024-07-08,香园围,出境,25754,3688,152,29594
2024-07-08,港珠澳大桥,入境,22621,6857,4320,33798
2024-07-08,港珠澳大桥,出境,18650,10752,3961,33363
2024-07-08,落马洲,入境,13402,3087,291,16780
2024-07-08,落马洲,出境,8886,3423,527,12836
2024-07-08,文锦渡,入境,1564,423,6,1993
2024-07-08,文锦渡,出境,1585,316,1,1902
2024-07-08,沙头角,入境,0,0,0,0
2024-07-08,沙头角,出境,0,0,0,0
2024-07-08,深圳湾,入境,29230,11572,901,41703
2024-07-08,深圳湾,出境,27440,9675,1322,38437
2024-07-08,中国客运码头,入境,570,614,81,1265
2024-07-08,中国客运码头,出境,580,449,116,1145
2024-07-08,港口管制,入境,0,0,36,36
2024-07-08,港口管制,出境,0,1,38,39
2024-07-08,启德邮轮码头,入境,0,0,0,0
2024-07-08,启德邮轮码头,出境,0,0,0,0
2024-07-08,港澳客轮码头,入境,5725,1259,1847,8831
2024-07-08,港澳客轮码头,出境,4947,1749,2109,8805
2024-07-09,机场,入境,30765,9958,12626,53349
2024-07-09,机场,出境,26097,9947,13643,49687
2024-07-09,高铁西九龙,入境,12719,18921,1181,32821
2024-07-09,高铁西九龙,出境,11891,15148,1127,28166
2024-07-09,红磡,入境,0,0,0,0
2024-07-09,红磡,出境,0,0,0,0
2024-07-09,罗湖,入境,59782,13950,635,74367
2024-07-09,罗湖,出境,58712,14851,664,74227
2024-07-09,落马洲支线,入境,48531,14515,399,63445
2024-07-09,落马洲支线,出境,49587,13171,410,63168
2024-07-09,香园围,入境,24972,7536,128,32636
2024-07-09,香园围,出境,25288,4070,114,29472
2024-07-09,港珠澳大桥,入境,17819,6685,4223,28727
2024-07-09,港珠澳大桥,出境,17729,10460,4038,32227
2024-07-09,落马洲,入境,10995,2724,246,13965
2024-07-09,落马洲,出境,9043,3158,460,12661
2024-07-09,文锦渡,入境,1480,479,13,1972
2024-07-09,文锦渡,出境,1660,385,4,2049
2024-07-09,沙头角,入境,0,0,0,0
2024-07-09,沙头角,出境,0,0,0,0
2024-07-09,深圳湾,入境,27507,11918,1053,40478
2024-07-09,深圳湾,出境,26294,10636,1126,38056
2024-07-09,中国客运码头,入境,514,497,67,1078
2024-07-09,中国客运码头,出境,557,584,119,1260
2024-07-09,港口管制,入境,39,0,45,84
2024-07-09,港口管制,出境,0,0,27,27
2024-07-09,启德邮轮码头,入境,0,0,0,0
2024-07-09,启德邮轮码头,出境,0,0,0,0
2024-07-09,港澳客轮码头,入境,5046,1270,1949,8265
2024-07-09,港澳客轮码头,出境,4630,1917,2105,8652
2024-07-10,机场,入境,27925,10603,13425,51953
2024-07-10,机场,出境,30433,10317,13501,54251
2024-07-10,高铁西九龙,入境,12301,19035,1249,32585
2024-07-10,高铁西九龙,出境,12940,16231,1230,30401
2024-07-10,红磡,入境,0,0,0,0
2024-07-10,红磡,出境,0,0,0,0
2024-07-10,罗湖,入境,60249,14387,649,75285
2024-07-10,罗湖,出境,59644,15377,642,75663
2024-07-10,落马洲支线,入境,49008,15148,382,64538
2024-07-10,落马洲支线,出境,50780,13482,376,64638
2024-07-10,香园围,入境,24658,7955,153,32766
2024-07-10,香园围,出境,24953,4624,157,29734
2024-07-10,港珠澳大桥,入境,17657,7603,3870,29130
2024-07-10,港珠澳大桥,出境,17819,11457,3861,33137
2024-07-10,落马洲,入境,10734,2699,350,13783
2024-07-10,落马洲,出境,9072,3040,441,12553
2024-07-10,文锦渡,入境,1556,465,14,2035
2024-07-10,文锦渡,出境,1690,361,12,2063
2024-07-10,沙头角,入境,0,0,0,0
2024-07-10,沙头角,出境,0,0,0,0
2024-07-10,深圳湾,入境,26660,12025,1132,39817
2024-07-10,深圳湾,出境,25885,10596,986,37467
2024-07-10,中国客运码头,入境,488,605,79,1172
2024-07-10,中国客运码头,出境,540,582,105,1227
2024-07-10,港口管制,入境,0,0,79,79
2024-07-10,港口管制,出境,80,0,75,155
2024-07-10,启德邮轮码头,入境,0,0,0,0
2024-07-10,启德邮轮码头,出境,0,0,0,0
2024-07-10,港澳客轮码头,入境,4769,1329,1864,7962
2024-07-10,港澳客轮码头,出境,4717,2202,2069,8988
2024-07-11,机场,入境,27706,10861,14742,53309
2024-07-11,机场,出境,34643,10965,13226,58834
2024-07-11,高铁西九龙,入境,12957,18300,1279,32536
2024-07-11,高铁西九龙,出境,14326,16988,1130,32444
2024-07-11,红磡,入境,0,0,0,0
2024-07-11,红磡,出境,0,0,0,0
2024-07-11,罗湖,入境,59869,14189,678,74736
2024-07-11,罗湖,出境,60843,16343,698,77884
2024-07-11,落马洲支线,入境,47963,15045,410,63418
2024-07-11,落马洲支线,出境,51008,14463,400,65871
2024-07-11,香园围,入境,24840,7603,135,32578
2024-07-11,香园围,出境,26125,4669,156,30950
2024-07-11,港珠澳大桥,入境,17748,7233,3968,28949
2024-07-11,港珠澳大桥,出境,19200,11446,3984,34630
2024-07-11,落马洲,入境,10443,2444,352,13239
2024-07-11,落马洲,出境,9037,3112,345,12494
2024-07-11,文锦渡,入境,1573,468,28,2069
2024-07-11,文锦渡,出境,1658,434,6,2098
2024-07-11,沙头角,入境,0,0,0,0
2024-07-11,沙头角,出境,0,0,0,0
2024-07-11,深圳湾,入境,25992,12043,1217,39252
2024-07-11,深圳湾,出境,26703,11443,975,39121
2024-07-11,中国客运码头,入境,486,529,107,1122
2024-07-11,中国客运码头,出境,517,581,122,1220
2024-07-11,港口管制,入境,0,0,22,22
2024-07-11,港口管制,出境,0,0,22,22
2024-07-11,启德邮轮码头,入境,0,0,0,0
2024-07-11,启德邮轮码头,出境,0,0,0,0
2024-07-11,港澳客轮码头,入境,4915,1436,1875,8226
2024-07-11,港澳客轮码头,出境,5187,2286,2125,9598
2024-07-12,机场,入境,27689,11347,16383,55419
2024-07-12,机场,出境,43505,11517,13066,68088
2024-07-12,高铁西九龙,入境,13230,21483,1457,36170
2024-07-12,高铁西九龙,出境,21822,17274,1190,40286
2024-07-12,红磡,入境,0,0,0,0
2024-07-12,红磡,出境,0,0,0,0
2024-07-12,罗湖,入境,61317,14962,734,77013
2024-07-12,罗湖,出境,74602,16919,758,92279
2024-07-12,落马洲支线,入境,49774,15667,402,65843
2024-07-12,落马洲支线,出境,62565,14840,402,77807
2024-07-12,香园围,入境,25377,6662,159,32198
2024-07-12,香园围,出境,29511,4433,301,34245
2024-07-12,港珠澳大桥,入境,18779,6770,3993,29542
2024-07-12,港珠澳大桥,出境,29101,11213,3869,44183
2024-07-12,落马洲,入境,11136,2879,515,14530
2024-07-12,落马洲,出境,11337,3173,367,14877
2024-07-12,文锦渡,入境,1492,460,10,1962
2024-07-12,文锦渡,出境,1881,377,3,2261
2024-07-12,沙头角,入境,0,0,0,0
2024-07-12,沙头角,出境,0,0,0,0
2024-07-12,深圳湾,入境,27546,13641,1257,42444
2024-07-12,深圳湾,出境,36815,11501,942,49258
2024-07-12,中国客运码头,入境,565,605,108,1278
2024-07-12,中国客运码头,出境,950,677,96,1723
2024-07-12,港口管制,入境,0,0,58,58
2024-07-12,港口管制,出境,1,0,52,53
2024-07-12,启德邮轮码头,入境,0,0,0,0
2024-07-12,启德邮轮码头,出境,0,0,0,0
2024-07-12,港澳客轮码头,入境,5508,1436,2149,9093
2024-07-12,港澳客轮码头,出境,6650,1907,2143,10700
2024-07-13,机场,入境,30073,11406,15893,57372
2024-07-13,机场,出境,39488,11960,13204,64652
2024-07-13,高铁西九龙,入境,13689,35325,1422,50436
2024-07-13,高铁西九龙,出境,26586,25336,1296,53218
2024-07-13,红磡,入境,0,0,0,0
2024-07-13,红磡,出境,0,0,0,0
2024-07-13,罗湖,入境,76503,21913,754,99170
2024-07-13,罗湖,出境,107997,25381,807,134185
2024-07-13,落马洲支线,入境,63680,26512,533,90725
2024-07-13,落马洲支线,出境,94204,23328,483,118015
2024-07-13,香园围,入境,31244,10624,169,42037
2024-07-13,香园围,出境,41709,6576,293,48578
2024-07-13,港珠澳大桥,入境,23143,8473,5989,37605
2024-07-13,港珠澳大桥,出境,42342,12056,5560,59958
2024-07-13,落马洲,入境,16541,3670,435,20646
2024-07-13,落马洲,出境,17244,5622,444,23310
2024-07-13,文锦渡,入境,1277,568,11,1856
2024-07-13,文锦渡,出境,1917,464,4,2385
2024-07-13,沙头角,入境,0,0,0,0
2024-07-13,沙头角,出境,0,0,0,0
2024-07-13,深圳湾,入境,35630,19990,1291,56911
2024-07-13,深圳湾,出境,53235,15484,1097,69816
2024-07-13,中国客运码头,入境,549,1117,127,1793
2024-07-13,中国客运码头,出境,1023,656,110,1789
2024-07-13,港口管制,入境,0,0,26,26
2024-07-13,港口管制,出境,1,3,33,37
2024-07-13,启德邮轮码头,入境,0,0,0,0
2024-07-13,启德邮轮码头,出境,0,0,0,0
2024-07-13,港澳客轮码头,入境,6012,1641,2472,10125
2024-07-13,港澳客轮码头,出境,8105,2234,2497,12836
2024-07-14,机场,入境,37443,11718,12813,61974
2024-07-14,机场,出境,34995,13772,17656,66423
2024-07-14,高铁西九龙,入境,23727,25708,1198,50633
2024-07-14,高铁西九龙,出境,15749,27855,1368,44972
2024-07-14,红磡,入境,0,0,0,0
2024-07-14,红磡,出境,0,0,0,0
2024-07-14,罗湖,入境,106565,19809,817,127191
2024-07-14,罗湖,出境,75512,25350,817,101679
2024-07-14,落马洲支线,入境,83613,21212,405,105230
2024-07-14,落马洲支线,出境,66853,21315,480,88648
2024-07-14,香园围,入境,40138,12013,173,52324
2024-07-14,香园围,出境,32456,7051,220,39727
2024-07-14,港珠澳大桥,入境,43430,10022,5746,59198
2024-07-14,港珠澳大桥,出境,25460,12627,6011,44098
2024-07-14,落马洲,入境,26182,3245,378,29805
2024-07-14,落马洲,出境,12914,5476,377,18767
2024-07-14,文锦渡,入境,1507,464,9,1980
2024-07-14,文锦渡,出境,1063,329,5,1397
2024-07-14,沙头角,入境,0,0,0,0
2024-07-14,沙头角,出境,0,0,0,0
2024-07-14,深圳湾,入境,55883,17379,1101,74363
2024-07-14,深圳湾,出境,37260,17781,1172,56213
2024-07-14,中国客运码头,入境,1180,856,94,2130
2024-07-14,中国客运码头,出境,444,780,138,1362
2024-07-14,港口管制,入境,0,0,23,23
2024-07-14,港口管制,出境,0,0,26,26
2024-07-14,启德邮轮码头,入境,0,0,0,0
2024-07-14,启德邮轮码头,出境,0,0,0,0
2024-07-14,港澳客轮码头,入境,8210,1301,2137,11648
2024-07-14,港澳客轮码头,出境,5004,2013,2803,9820
2024-07-15,机场,入境,35175,12743,14170,62088
2024-07-15,机场,出境,33172,11895,16865,61932
2024-07-15,高铁西九龙,入境,16825,21675,1239,39739
2024-07-15,高铁西九龙,出境,15833,18589,1307,35729
2024-07-15,红磡,入境,0,0,0,0
2024-07-15,红磡,出境,0,0,0,0
2024-07-15,罗湖,入境,69063,15977,685,85725
2024-07-15,罗湖,出境,63786,17475,733,81994
2024-07-15,落马洲支线,入境,52949,15188,348,68485
2024-07-15,落马洲支线,出境,52513,13927,409,66849
2024-07-15,香园围,入境,26022,9399,173,35594
2024-07-15,香园围,出境,25368,4733,161,30262
2024-07-15,港珠澳大桥,入境,25415,7747,4360,37522
2024-07-15,港珠澳大桥,出境,20071,12027,4007,36105
2024-07-15,落马洲,入境,14169,3643,317,18129
2024-07-15,落马洲,出境,9629,4685,557,14871
2024-07-15,文锦渡,入境,1568,416,8,1992
2024-07-15,文锦渡,出境,1587,319,8,1914
2024-07-15,沙头角,入境,0,0,0,0
2024-07-15,沙头角,出境,0,0,0,0
2024-07-15,深圳湾,入境,31330,13539,1060,45929
2024-07-15,深圳湾,出境,29184,11750,1220,42154
2024-07-15,中国客运码头,入境,592,670,100,1362
2024-07-15,中国客运码头,出境,640,677,147,1464
2024-07-15,港口管制,入境,18,0,50,68
2024-07-15,港口管制,出境,2,0,30,32
2024-07-15,启德邮轮码头,入境,0,0,0,0
2024-07-15,启德邮轮码头,出境,0,0,0,0
2024-07-15,港澳客轮码头,入境,5631,1306,1837,8774
2024-07-15,港澳客轮码头,出境,4820,1857,1733,8410
2024-07-16,机场,入境,30429,11251,12542,54222
2024-07-16,机场,出境,33538,10976,13111,57625
2024-07-16,高铁西九龙,入境,13234,21696,1189,36119
2024-07-16,高铁西九龙,出境,15631,17238,1057,33926
2024-07-16,红磡,入境,0,0,0,0
2024-07-16,红磡,出境,0,0,0,0
2024-07-16,罗湖,入境,61212,15730,608,77550
2024-07-16,罗湖,出境,62051,16836,594,79481
2024-07-16,落马洲支线,入境,47853,15168,358,63379
2024-07-16,落马洲支线,出境,51363,13998,401,65762
2024-07-16,香园围,入境,24549,8829,159,33537
2024-07-16,香园围,出境,25110,4201,153,29464
2024-07-16,港珠澳大桥,入境,19383,7834,3870,31087
2024-07-16,港珠澳大桥,出境,19407,12457,3453,35317
2024-07-16,落马洲,入境,10528,2951,351,13830
2024-07-16,落马洲,出境,8947,3149,473,12569
2024-07-16,文锦渡,入境,1462,437,14,1913
2024-07-16,文锦渡,出境,1497,336,14,1847
2024-07-16,沙头角,入境,0,0,0,0
2024-07-16,沙头角,出境,0,0,0,0
2024-07-16,深圳湾,入境,27702,13545,1007,42254
2024-07-16,深圳湾,出境,28043,11340,1076,40459
2024-07-16,中国客运码头,入境,384,736,96,1216
2024-07-16,中国客运码头,出境,546,704,114,1364
2024-07-16,港口管制,入境,2,4,42,48
2024-07-16,港口管制,出境,2,0,36,38
2024-07-16,启德邮轮码头,入境,0,0,0,0
2024-07-16,启德邮轮码头,出境,0,0,0,0
2024-07-16,港澳客轮码头,入境,4910,1341,1554,7805
2024-07-16,港澳客轮码头,出境,4789,2214,1750,8753
2024-07-17,机场,入境,27993,11221,12863,52077
2024-07-17,机场,出境,38183,10041,12932,61156
2024-07-17,高铁西九龙,入境,12200,20480,1112,33792
2024-07-17,高铁西九龙,出境,16247,17796,1075,35118
2024-07-17,红磡,入境,0,0,0,0
2024-07-17,红磡,出境,0,0,0,0
2024-07-17,罗湖,入境,61321,14884,673,76878
2024-07-17,罗湖,出境,62684,16827,696,80207
2024-07-17,落马洲支线,入境,47854,14954,389,63197
2024-07-17,落马洲支线,出境,52573,13945,379,66897
2024-07-17,香园围,入境,24956,10471,130,35557
2024-07-17,香园围,出境,26406,4410,148,30964
2024-07-17,港珠澳大桥,入境,18802,8285,4080,31167
2024-07-17,港珠澳大桥,出境,20097,13755,3878,37730
2024-07-17,落马洲,入境,10793,2752,399,13944
2024-07-17,落马洲,出境,9356,4472,416,14244
2024-07-17,文锦渡,入境,1376,393,10,1779
2024-07-17,文锦渡,出境,1473,342,4,1819
2024-07-17,沙头角,入境,0,0,0,0
2024-07-17,沙头角,出境,0,0,0,0
2024-07-17,深圳湾,入境,27154,13027,1087,41268
2024-07-17,深圳湾,出境,28645,11359,979,40983
2024-07-17,中国客运码头,入境,494,788,113,1395
2024-07-17,中国客运码头,出境,622,650,142,1414
2024-07-17,港口管制,入境,0,0,50,50
2024-07-17,港口管制,出境,20,0,39,59
2024-07-17,启德邮轮码头,入境,0,0,0,0
2024-07-17,启德邮轮码头,出境,0,0,0,0
2024-07-17,港澳客轮码头,入境,4979,1429,1739,8147
2024-07-17,港澳客轮码头,出境,4857,2526,1917,9300
2024-07-18,机场,入境,28305,12001,14415,54721
2024-07-18,机场,出境,42215,10031,12301,64547
2024-07-18,高铁西九龙,入境,12686,19300,1276,33262
2024-07-18,高铁西九龙,出境,18413,18779,1101,38293
2024-07-18,红磡,入境,0,0,0,0
2024-07-18,红磡,出境,0,0,0,0
2024-07-18,罗湖,入境,60327,14893,624,75844
2024-07-18,罗湖,出境,61822,17276,716,79814
2024-07-18,落马洲支线,入境,47280,14274,356,61910
2024-07-18,落马洲支线,出境,51418,13964,331,65713
2024-07-18,香园围,入境,24827,9574,161,34562
2024-07-18,香园围,出境,25991,4632,267,30890
2024-07-18,港珠澳大桥,入境,18965,8067,3734,30766
2024-07-18,港珠澳大桥,出境,20718,15273,3914,39905
2024-07-18,落马洲,入境,10813,2411,400,13624
2024-07-18,落马洲,出境,9167,4086,348,13601
2024-07-18,文锦渡,入境,1287,375,8,1670
2024-07-18,文锦渡,出境,1349,275,7,1631
2024-07-18,沙头角,入境,0,0,0,0
2024-07-18,沙头角,出境,0,0,0,0
2024-07-18,深圳湾,入境,26573,12206,1141,39920
2024-07-18,深圳湾,出境,28479,11688,934,41101
2024-07-18,中国客运码头,入境,520,672,126,1318
2024-07-18,中国客运码头,出境,594,753,85,1432
2024-07-18,港口管制,入境,79,0,31,110
2024-07-18,港口管制,出境,2,0,83,85
2024-07-18,启德邮轮码头,入境,0,0,0,0
2024-07-18,启德邮轮码头,出境,0,0,0,0
2024-07-18,港澳客轮码头,入境,4900,1543,1562,8005
2024-07-18,港澳客轮码头,出境,4848,2349,1898,9095
2024-07-19,机场,入境,30312,12237,15901,58450
2024-07-19,机场,出境,45492,11093,13285,69870
2024-07-19,高铁西九龙,入境,13800,22686,1293,37779
2024-07-19,高铁西九龙,出境,24410,19330,1068,44808
2024-07-19,红磡,入境,0,0,0,0
2024-07-19,红磡,出境,0,0,0,0
2024-07-19,罗湖,入境,60753,15764,703,77220
2024-07-19,罗湖,出境,73134,19048,770,92952
2024-07-19,落马洲支线,入境,47759,15878,457,64094
2024-07-19,落马洲支线,出境,60490,14970,423,75883
2024-07-19,香园围,入境,24458,8762,232,33452
2024-07-19,香园围,出境,27453,5814,233,33500
2024-07-19,港珠澳大桥,入境,20078,7888,4577,32543
2024-07-19,港珠澳大桥,出境,29675,15043,4201,48919
2024-07-19,落马洲,入境,10947,2989,614,14550
2024-07-19,落马洲,出境,11275,3652,411,15338
2024-07-19,文锦渡,入境,1233,401,12,1646
2024-07-19,文锦渡,出境,1497,344,32,1873
2024-07-19,沙头角,入境,0,0,0,0
2024-07-19,沙头角,出境,0,0,0,0
2024-07-19,深圳湾,入境,27984,13867,1298,43149
2024-07-19,深圳湾,出境,36406,12782,884,50072
2024-07-19,中国客运码头,入境,628,748,97,1473
2024-07-19,中国客运码头,出境,1013,734,110,1857
2024-07-19,港口管制,入境,0,0,53,53
2024-07-19,港口管制,出境,72,0,47,119
2024-07-19,启德邮轮码头,入境,0,0,0,0
2024-07-19,启德邮轮码头,出境,0,0,0,0
2024-07-19,港澳客轮码头,入境,5581,1639,2241,9461
2024-07-19,港澳客轮码头,出境,6526,2331,2100,10957
2024-07-20,机场,入境,34294,12051,16348,62693
2024-07-20,机场,出境,43380,11253,13065,67698
2024-07-20,高铁西九龙,入境,14508,35429,1445,51382
2024-07-20,高铁西九龙,出境,27459,26646,1127,55232
2024-07-20,红磡,入境,0,0,0,0
2024-07-20,红磡,出境,0,0,0,0
2024-07-20,罗湖,入境,74292,23240,893,98425
2024-07-20,罗湖,出境,104752,27798,940,133490
2024-07-20,落马洲支线,入境,60603,27434,577,88614
2024-07-20,落马洲支线,出境,91488,25427,590,117505
2024-07-20,香园围,入境,30490,11235,187,41912
2024-07-20,香园围,出境,39584,6872,301,46757
2024-07-20,港珠澳大桥,入境,23470,10205,6488,40163
2024-07-20,港珠澳大桥,出境,41401,14068,5355,60824
2024-07-20,落马洲,入境,16525,3647,401,20573
2024-07-20,落马洲,出境,17410,5548,377,23335
2024-07-20,文锦渡,入境,1136,550,10,1696
2024-07-20,文锦渡,出境,1859,490,7,2356
2024-07-20,沙头角,入境,0,0,0,0
2024-07-20,沙头角,出境,0,0,0,0
2024-07-20,深圳湾,入境,34661,20343,1270,56274
2024-07-20,深圳湾,出境,51570,17089,1056,69715
2024-07-20,中国客运码头,入境,538,1015,110,1663
2024-07-20,中国客运码头,出境,1003,734,131,1868
2024-07-20,港口管制,入境,0,0,44,44
2024-07-20,港口管制,出境,0,0,21,21
2024-07-20,启德邮轮码头,入境,0,0,0,0
2024-07-20,启德邮轮码头,出境,0,0,0,0
2024-07-20,港澳客轮码头,入境,5763,1754,2882,10399
2024-07-20,港澳客轮码头,出境,8067,2297,2610,12974
2024-07-21,机场,入境,43258,12309,13247,68814
2024-07-21,机场,出境,40844,12756,17752,71352
2024-07-21,高铁西九龙,入境,25638,27166,1316,54120
2024-07-21,高铁西九龙,出境,16751,28880,1384,47015
2024-07-21,红磡,入境,0,0,0,0
2024-07-21,红磡,出境,0,0,0,0
2024-07-21,罗湖,入境,106099,19091,838,126028
2024-07-21,罗湖,出境,74378,25474,810,100662
2024-07-21,落马洲支线,入境,84038,20869,533,105440
2024-07-21,落马洲支线,出境,67798,22137,510,90445
2024-07-21,香园围,入境,39963,13871,335,54169
2024-07-21,香园围,出境,33025,7036,411,40472
2024-07-21,港珠澳大桥,入境,43915,9545,5942,59402
2024-07-21,港珠澳大桥,出境,25988,12703,6201,44892
2024-07-21,落马洲,入境,26039,3206,428,29673
2024-07-21,落马洲,出境,13136,6077,567,19780
2024-07-21,文锦渡,入境,1491,453,7,1951
2024-07-21,文锦渡,出境,1108,381,7,1496
2024-07-21,沙头角,入境,0,0,0,0
2024-07-21,沙头角,出境,0,0,0,0
2024-07-21,深圳湾,入境,56789,15162,1085,73036
2024-07-21,深圳湾,出境,37790,17320,1246,56356
2024-07-21,中国客运码头,入境,1174,802,102,2078
2024-07-21,中国客运码头,出境,451,946,97,1494
2024-07-21,港口管制,入境,0,0,21,21
2024-07-21,港口管制,出境,0,7,40,47
2024-07-21,启德邮轮码头,入境,0,0,0,0
2024-07-21,启德邮轮码头,出境,0,0,0,0
2024-07-21,港澳客轮码头,入境,7869,1755,1716,11340
2024-07-21,港澳客轮码头,出境,4853,2573,2208,9634
2024-07-22,机场,入境,38294,12864,14239,65397
2024-07-22,机场,出境,38547,10485,16624,65656
2024-07-22,高铁西九龙,入境,18067,22183,1266,41516
2024-07-22,高铁西九龙,出境,16477,18384,1262,36123
2024-07-22,红磡,入境,0,0,0,0
2024-07-22,红磡,出境,0,0,0,0
2024-07-22,罗湖,入境,67631,15994,682,84307
2024-07-22,罗湖,出境,61416,17593,758,79767
2024-07-22,落马洲支线,入境,52503,14993,373,67869
2024-07-22,落马洲支线,出境,50920,13154,421,64495
2024-07-22,香园围,入境,25847,10600,205,36652
2024-07-22,香园围,出境,24282,4169,209,28660
2024-07-22,港珠澳大桥,入境,25515,7168,4772,37455
2024-07-22,港珠澳大桥,出境,19873,14982,4211,39066
2024-07-22,落马洲,入境,14409,3354,318,18081
2024-07-22,落马洲,出境,9178,5006,578,14762
2024-07-22,文锦渡,入境,1376,431,1,1808
2024-07-22,文锦渡,出境,1377,292,23,1692
2024-07-22,沙头角,入境,0,0,0,0
2024-07-22,沙头角,出境,0,0,0,0
2024-07-22,深圳湾,入境,31258,12302,1038,44598
2024-07-22,深圳湾,出境,28243,11749,1289,41281
2024-07-22,中国客运码头,入境,578,585,97,1260
2024-07-22,中国客运码头,出境,605,635,180,1420
2024-07-22,港口管制,入境,0,0,80,80
2024-07-22,港口管制,出境,1,0,26,27
2024-07-22,启德邮轮码头,入境,0,0,0,0
2024-07-22,启德邮轮码头,出境,0,0,0,0
2024-07-22,港澳客轮码头,入境,5270,1513,1613,8396
2024-07-22,港澳客轮码头,出境,4584,2232,2414,9230
2024-07-23,机场,入境,36026,11636,12314,59976
2024-07-23,机场,出境,33790,10465,13887,58142
2024-07-23,高铁西九龙,入境,14499,22882,1219,38600
2024-07-23,高铁西九龙,出境,14709,17981,1096,33786
2024-07-23,红磡,入境,0,0,0,0
2024-07-23,红磡,出境,0,0,0,0
2024-07-23,罗湖,入境,61374,15658,692,77724
2024-07-23,罗湖,出境,60919,17226,668,78813
2024-07-23,落马洲支线,入境,48608,15318,357,64283
2024-07-23,落马洲支线,出境,50556,13411,416,64383
2024-07-23,香园围,入境,25411,9898,180,35489
2024-07-23,香园围,出境,25259,4517,194,29970
2024-07-23,港珠澳大桥,入境,20039,8037,4504,32580
2024-07-23,港珠澳大桥,出境,19818,14593,3631,38042
2024-07-23,落马洲,入境,10967,3104,289,14360
2024-07-23,落马洲,出境,9071,3317,417,12805
2024-07-23,文锦渡,入境,1294,404,16,1714
2024-07-23,文锦渡,出境,1432,308,5,1745
2024-07-23,沙头角,入境,0,0,0,0
2024-07-23,沙头角,出境,0,0,0,0
2024-07-23,深圳湾,入境,28405,13076,1067,42548
2024-07-23,深圳湾,出境,27708,11188,1019,39915
2024-07-23,中国客运码头,入境,507,713,64,1284
2024-07-23,中国客运码头,出境,579,561,102,1242
2024-07-23,港口管制,入境,23,0,23,46
2024-07-23,港口管制,出境,0,1,107,108
2024-07-23,启德邮轮码头,入境,1,1,755,757
2024-07-23,启德邮轮码头,出境,0,0,0,0
2024-07-23,港澳客轮码头,入境,5048,1575,2162,8785
2024-07-23,港澳客轮码头,出境,4937,2426,2079,9442
2024-07-24,机场,入境,33040,11930,13879,58849
2024-07-24,机场,出境,36106,9904,12429,58439
2024-07-24,高铁西九龙,入境,14115,22530,1301,37946
2024-07-24,高铁西九龙,出境,15643,19244,1192,36079
2024-07-24,红磡,入境,0,0,0,0
2024-07-24,红磡,出境,0,0,0,0
2024-07-24,罗湖,入境,62175,15399,718,78292
2024-07-24,罗湖,出境,61730,18045,815,80590
2024-07-24,落马洲支线,入境,49454,15568,404,65426
2024-07-24,落马洲支线,出境,52436,14157,377,66970
2024-07-24,香园围,入境,25593,10053,117,35763
2024-07-24,香园围,出境,26081,4257,151,30489
2024-07-24,港珠澳大桥,入境,20107,8860,4984,33951
2024-07-24,港珠澳大桥,出境,20918,15370,3992,40280
2024-07-24,落马洲,入境,10958,2948,372,14278
2024-07-24,落马洲,出境,9177,5079,388,14644
2024-07-24,文锦渡,入境,1376,488,14,1878
2024-07-24,文锦渡,出境,1474,411,14,1899
2024-07-24,沙头角,入境,0,0,0,0
2024-07-24,沙头角,出境,0,0,0,0
2024-07-24,深圳湾,入境,27333,12998,1108,41439
2024-07-24,深圳湾,出境,27179,11948,1021,40148
2024-07-24,中国客运码头,入境,458,766,81,1305
2024-07-24,中国客运码头,出境,500,699,115,1314
2024-07-24,港口管制,入境,0,0,22,22
2024-07-24,港口管制,出境,1,0,23,24
2024-07-24,启德邮轮码头,入境,0,0,0,0
2024-07-24,启德邮轮码头,出境,1,0,754,755
2024-07-24,港澳客轮码头,入境,4957,1702,1870,8529
2024-07-24,港澳客轮码头,出境,4939,2628,2145,9712
2024-07-25,机场,入境,32054,12356,13836,58246
2024-07-25,机场,出境,39715,10690,13915,64320
2024-07-25,高铁西九龙,入境,11897,19856,1303,33056
2024-07-25,高铁西九龙,出境,13937,18738,1087,33762
2024-07-25,红磡,入境,0,0,0,0
2024-07-25,红磡,出境,0,0,0,0
2024-07-25,罗湖,入境,61727,15245,694,77666
2024-07-25,罗湖,出境,61887,18025,737,80649
2024-07-25,落马洲支线,入境,48109,14568,393,63070
2024-07-25,落马洲支线,出境,52319,13762,403,66484
2024-07-25,香园围,入境,25131,8855,229,34215
2024-07-25,香园围,出境,26115,5550,201,31866
2024-07-25,港珠澳大桥,入境,20094,8834,4547,33475
2024-07-25,港珠澳大桥,出境,21715,14751,3938,40404
2024-07-25,落马洲,入境,11095,2818,477,14390
2024-07-25,落马洲,出境,9378,4771,280,14429
2024-07-25,文锦渡,入境,1284,422,11,1717
2024-07-25,文锦渡,出境,1426,318,19,1763
2024-07-25,沙头角,入境,0,0,0,0
2024-07-25,沙头角,出境,0,0,0,0
2024-07-25,深圳湾,入境,27499,12911,1278,41688
2024-07-25,深圳湾,出境,28400,11919,835,41154
2024-07-25,中国客运码头,入境,556,711,90,1357
2024-07-25,中国客运码头,出境,620,837,115,1572
2024-07-25,港口管制,入境,0,0,22,22
2024-07-25,港口管制,出境,1,2,15,18
2024-07-25,启德邮轮码头,入境,0,0,0,0
2024-07-25,启德邮轮码头,出境,0,0,0,0
2024-07-25,港澳客轮码头,入境,5045,1584,1930,8559
2024-07-25,港澳客轮码头,出境,4885,2581,2293,9759
2024-07-26,机场,入境,36350,12991,17271,66612
2024-07-26,机场,出境,44448,11194,14865,70507
2024-07-26,高铁西九龙,入境,13492,23014,1408,37914
2024-07-26,高铁西九龙,出境,21813,18965,1061,41839
2024-07-26,红磡,入境,0,0,0,0
2024-07-26,红磡,出境,0,0,0,0
2024-07-26,罗湖,入境,60067,16294,733,77094
2024-07-26,罗湖,出境,70987,18635,759,90381
2024-07-26,落马洲支线,入境,47271,15940,449,63660
2024-07-26,落马洲支线,出境,59112,14995,375,74482
2024-07-26,香园围,入境,23340,7702,195,31237
2024-07-26,香园围,出境,26505,4709,303,31517
2024-07-26,港珠澳大桥,入境,20620,10042,5148,35810
2024-07-26,港珠澳大桥,出境,30339,13336,4295,47970
2024-07-26,落马洲,入境,10999,2850,583,14432
2024-07-26,落马洲,出境,11160,3648,441,15249
2024-07-26,文锦渡,入境,1230,352,12,1594
2024-07-26,文锦渡,出境,1397,257,4,1658
2024-07-26,沙头角,入境,0,0,0,0
2024-07-26,沙头角,出境,0,0,0,0
2024-07-26,深圳湾,入境,27174,14855,1403,43432
2024-07-26,深圳湾,出境,34970,12885,898,48753
2024-07-26,中国客运码头,入境,597,771,93,1461
2024-07-26,中国客运码头,出境,896,718,93,1707
2024-07-26,港口管制,入境,3,0,22,25
2024-07-26,港口管制,出境,2,0,35,37
2024-07-26,启德邮轮码头,入境,0,0,0,0
2024-07-26,启德邮轮码头,出境,0,0,0,0
2024-07-26,港澳客轮码头,入境,5174,1575,2083,8832
2024-07-26,港澳客轮码头,出境,6446,2311,2316,11073
2024-07-27,机场,入境,36768,11892,17901,66561
2024-07-27,机场,出境,42651,11373,14873,68897
2024-07-27,高铁西九龙,入境,13253,29786,1353,44392
2024-07-27,高铁西九龙,出境,22000,23526,1091,46617
2024-07-27,红磡,入境,0,0,0,0
2024-07-27,红磡,出境,0,0,0,0
2024-07-27,罗湖,入境,69891,19909,808,90608
2024-07-27,罗湖,出境,98817,23899,764,123480
2024-07-27,落马洲支线,入境,57673,21451,585,79709
2024-07-27,落马洲支线,出境,85286,20356,465,106107
2024-07-27,香园围,入境,26812,12125,300,39237
2024-07-27,香园围,出境,36041,6836,219,43096
2024-07-27,港珠澳大桥,入境,23910,9823,6429,40162
2024-07-27,港珠澳大桥,出境,42981,14861,5118,62960
2024-07-27,落马洲,入境,14779,3026,504,18309
2024-07-27,落马洲,出境,16133,5303,402,21838
2024-07-27,文锦渡,入境,1110,423,21,1554
2024-07-27,文锦渡,出境,1603,357,18,1978
2024-07-27,沙头角,入境,0,0,0,0
2024-07-27,沙头角,出境,0,0,0,0
2024-07-27,深圳湾,入境,32182,17627,1281,51090
2024-07-27,深圳湾,出境,48787,15650,916,65353
2024-07-27,中国客运码头,入境,485,939,105,1529
2024-07-27,中国客运码头,出境,890,739,98,1727
2024-07-27,港口管制,入境,2,0,23,25
2024-07-27,港口管制,出境,2,0,25,27
2024-07-27,启德邮轮码头,入境,0,0,0,0
2024-07-27,启德邮轮码头,出境,0,0,0,0
2024-07-27,港澳客轮码头,入境,5398,1628,2341,9367
2024-07-27,港澳客轮码头,出境,7732,2429,2396,12557
2024-07-28,机场,入境,46007,12669,13854,72530
2024-07-28,机场,出境,37227,12758,18521,68506
2024-07-28,高铁西九龙,入境,21199,21848,1243,44290
2024-07-28,高铁西九龙,出境,12833,23365,1082,37280
2024-07-28,红磡,入境,0,0,0,0
2024-07-28,红磡,出境,0,0,0,0
2024-07-28,罗湖,入境,101271,16324,779,118374
2024-07-28,罗湖,出境,69430,22107,689,92226
2024-07-28,落马洲支线,入境,79028,16274,439,95741
2024-07-28,落马洲支线,出境,62184,17481,445,80110
2024-07-28,香园围,入境,37698,12982,314,50994
2024-07-28,香园围,出境,28071,7977,310,36358
2024-07-28,港珠澳大桥,入境,44741,9609,6129,60479
2024-07-28,港珠澳大桥,出境,26763,13424,5969,46156
2024-07-28,落马洲,入境,23980,2899,368,27247
2024-07-28,落马洲,出境,11680,5578,492,17750
2024-07-28,文锦渡,入境,1317,327,7,1651
2024-07-28,文锦渡,出境,961,246,10,1217
2024-07-28,沙头角,入境,0,0,0,0
2024-07-28,沙头角,出境,0,0,0,0
2024-07-28,深圳湾,入境,55323,14105,1272,70700
2024-07-28,深圳湾,出境,35085,16836,1163,53084
2024-07-28,中国客运码头,入境,1176,750,120,2046
2024-07-28,中国客运码头,出境,455,830,147,1432
2024-07-28,港口管制,入境,0,0,26,26
2024-07-28,港口管制,出境,0,0,18,18
2024-07-28,启德邮轮码头,入境,0,0,0,0
2024-07-28,启德邮轮码头,出境,0,0,0,0
2024-07-28,港澳客轮码头,入境,7945,1436,2024,11405
2024-07-28,港澳客轮码头,出境,5488,2215,2648,10351
2024-07-29,机场,入境,43546,13394,13660,70600
2024-07-29,机场,出境,34586,11144,18565,64295
2024-07-29,高铁西九龙,入境,19837,22882,1366,44085
2024-07-29,高铁西九龙,出境,16666,18382,1264,36312
2024-07-29,红磡,入境,0,0,0,0
2024-07-29,红磡,出境,0,0,0,0
2024-07-29,罗湖,入境,67660,14969,745,83374
2024-07-29,罗湖,出境,58924,16510,714,76148
2024-07-29,落马洲支线,入境,52776,14328,433,67537
2024-07-29,落马洲支线,出境,50044,13267,484,63795
2024-07-29,香园围,入境,25555,8109,173,33837
2024-07-29,香园围,出境,24003,6326,368,30697
2024-07-29,港珠澳大桥,入境,28949,7902,4660,41511
2024-07-29,港珠澳大桥,出境,20659,12833,4546,38038
2024-07-29,落马洲,入境,13839,3220,359,17418
2024-07-29,落马洲,出境,9066,4974,532,14572
2024-07-29,文锦渡,入境,1266,401,9,1676
2024-07-29,文锦渡,出境,1229,311,6,1546
2024-07-29,沙头角,入境,0,0,0,0
2024-07-29,沙头角,出境,0,0,0,0
2024-07-29,深圳湾,入境,32679,12397,1075,46151
2024-07-29,深圳湾,出境,27852,12807,1190,41849
2024-07-29,中国客运码头,入境,578,706,109,1393
2024-07-29,中国客运码头,出境,561,604,131,1296
2024-07-29,港口管制,入境,4,2,43,49
2024-07-29,港口管制,出境,1,2,36,39
2024-07-29,启德邮轮码头,入境,0,0,0,0
2024-07-29,启德邮轮码头,出境,0,0,0,0
2024-07-29,港澳客轮码头,入境,5825,1459,2019,9303
2024-07-29,港澳客轮码头,出境,4713,2079,2403,9195
2024-07-30,机场,入境,38571,11390,11588,61549
2024-07-30,机场,出境,31492,10969,15916,58377
2024-07-30,高铁西九龙,入境,15678,19978,1314,36970
2024-07-30,高铁西九龙,出境,14938,17363,1020,33321
2024-07-30,红磡,入境,0,0,0,0
2024-07-30,红磡,出境,0,0,0,0
2024-07-30,罗湖,入境,60940,14621,712,76273
2024-07-30,罗湖,出境,59332,16975,626,76933
2024-07-30,落马洲支线,入境,48037,14274,399,62710
2024-07-30,落马洲支线,出境,48567,13552,359,62478
2024-07-30,香园围,入境,24836,8841,152,33829
2024-07-30,香园围,出境,24241,4903,176,29320
2024-07-30,港珠澳大桥,入境,20779,7757,4587,33123
2024-07-30,港珠澳大桥,出境,19136,12893,4066,36095
2024-07-30,落马洲,入境,10756,2919,361,14036
2024-07-30,落马洲,出境,8921,3150,423,12494
2024-07-30,文锦渡,入境,1183,481,14,1678
2024-07-30,文锦渡,出境,1391,371,6,1768
2024-07-30,沙头角,入境,0,0,0,0
2024-07-30,沙头角,出境,0,0,0,0
2024-07-30,深圳湾,入境,27948,11919,1139,41006
2024-07-30,深圳湾,出境,26326,11640,997,38963
2024-07-30,中国客运码头,入境,522,616,96,1234
2024-07-30,中国客运码头,出境,549,733,119,1401
2024-07-30,港口管制,入境,3,0,49,52
2024-07-30,港口管制,出境,3,1,51,55
2024-07-30,启德邮轮码头,入境,0,0,0,0
2024-07-30,启德邮轮码头,出境,0,0,0,0
2024-07-30,港澳客轮码头,入境,5051,1683,1981,8715
2024-07-30,港澳客轮码头,出境,4652,2352,2258,9262
2024-07-31,机场,入境,39416,12445,12230,64091
2024-07-31,机场,出境,35438,10274,15022,60734
2024-07-31,高铁西九龙,入境,14942,20139,1372,36453
2024-07-31,高铁西九龙,出境,14891,17526,1065,33482
2024-07-31,罗湖,入境,60016,13849,588,74453
2024-07-31,罗湖,出境,58767,16039,618,75424
2024-07-31,落马洲支线,入境,46633,13643,349,60625
2024-07-31,落马洲支线,出境,48229,12844,354,61427
2024-07-31,香园围,入境,23514,8301,228,32043
2024-07-31,香园围,出境,23099,4511,110,27720
2024-07-31,港珠澳大桥,入境,19630,8404,4180,32214
2024-07-31,港珠澳大桥,出境,18988,13292,3823,36103
2024-07-31,落马洲,入境,11050,2643,361,14054
2024-07-31,落马洲,出境,9114,3402,373,12889
2024-07-31,文锦渡,入境,1167,360,14,1541
2024-07-31,文锦渡,出境,1224,301,10,1535
2024-07-31,沙头角,入境,0,0,0,0
2024-07-31,沙头角,出境,0,0,0,0
2024-07-31,深圳湾,入境,27488,11052,1120,39660
2024-07-31,深圳湾,出境,25782,11118,939,37839
2024-07-31,中国客运码头,入境,481,574,73,1128
2024-07-31,中国客运码头,出境,462,659,106,1227
2024-07-31,港口管制,入境,0,3,35,38
2024-07-31,港口管制,出境,0,1,27,28
2024-07-31,启德邮轮码头,入境,0,0,0,0
2024-07-31,启德邮轮码头,出境,0,0,0,0
2024-07-31,港澳客轮码头,入境,4801,1606,1788,8195
2024-07-31,港澳客轮码头,出境,4734,2427,1918,9079
2024-08-01,机场,入境,35765,13712,14735,64212
2024-08-01,机场,出境,42705,10081,12472,65258
2024-08-01,高铁西九龙,入境,13799,24862,1266,39927
2024-08-01,高铁西九龙,出境,17289,17992,1109,36390
2024-08-01,罗湖,入境,60070,16229,647,76946
2024-08-01,罗湖,出境,62059,17583,743,80385
2024-08-01,落马洲支线,入境,47077,15735,388,63200
2024-08-01,落马洲支线,出境,51571,13625,388,65584
2024-08-01,香园围,入境,25167,8164,204,33535
2024-08-01,香园围,出境,26091,4780,158,31029
2024-08-01,港珠澳大桥,入境,19195,9045,4190,32430
2024-08-01,港珠澳大桥,出境,21344,13911,3727,38982
2024-08-01,落马洲,入境,10828,2840,395,14063
2024-08-01,落马洲,出境,9210,3322,365,12897
2024-08-01,文锦渡,入境,1228,416,18,1662
2024-08-01,文锦渡,出境,1356,339,35,1730
2024-08-01,沙头角,入境,0,0,0,0
2024-08-01,沙头角,出境,0,0,0,0
2024-08-01,深圳湾,入境,26394,14030,1084,41508
2024-08-01,深圳湾,出境,28604,11693,937,41234
2024-08-01,中国客运码头,入境,500,762,122,1384
2024-08-01,中国客运码头,出境,532,575,138,1245
2024-08-01,港口管制,入境,0,0,101,101
2024-08-01,港口管制,出境,4,1,81,86
2024-08-01,启德邮轮码头,入境,0,0,0,0
2024-08-01,启德邮轮码头,出境,0,0,0,0
2024-08-01,港澳客轮码头,入境,5060,1768,2040,8868
2024-08-01,港澳客轮码头,出境,5099,2550,2482,10131
2024-08-02,机场,入境,36080,14551,15016,65647
2024-08-02,机场,出境,43151,11405,12960,67516
2024-08-02,高铁西九龙,入境,14631,28388,1426,44445
2024-08-02,高铁西九龙,出境,23747,21279,1020,46046
2024-08-02,罗湖,入境,62181,17934,697,80812
2024-08-02,罗湖,出境,73415,20539,753,94707
2024-08-02,落马洲支线,入境,48084,16865,474,65423
2024-08-02,落马洲支线,出境,60816,15693,400,76909
2024-08-02,香园围,入境,25697,9268,144,35109
2024-08-02,香园围,出境,28807,5085,263,34155
2024-08-02,港珠澳大桥,入境,20334,9386,4955,34675
2024-08-02,港珠澳大桥,出境,32599,13748,4210,50557
2024-08-02,落马洲,入境,11277,2999,453,14729
2024-08-02,落马洲,出境,11480,3832,360,15672
2024-08-02,文锦渡,入境,1238,422,11,1671
2024-08-02,文锦渡,出境,1530,309,9,1848
2024-08-02,沙头角,入境,0,0,0,0
2024-08-02,沙头角,出境,0,0,0,0
2024-08-02,深圳湾,入境,28108,14897,1374,44379
2024-08-02,深圳湾,出境,36411,12783,943,50137
2024-08-02,中国客运码头,入境,577,734,120,1431
2024-08-02,中国客运码头,出境,949,711,143,1803
2024-08-02,港口管制,入境,5,2,59,66
2024-08-02,港口管制,出境,1,2,40,43
2024-08-02,启德邮轮码头,入境,0,0,0,0
2024-08-02,启德邮轮码头,出境,0,0,0,0
2024-08-02,港澳客轮码头,入境,5423,2023,2686,10132
2024-08-02,港澳客轮码头,出境,7032,2634,2615,12281
2024-08-03,机场,入境,38386,13511,14651,66548
2024-08-03,机场,出境,40025,11219,14019,65263
2024-08-03,高铁西九龙,入境,15444,40421,1362,57227
2024-08-03,高铁西九龙,出境,25603,27720,1140,54463
2024-08-03,罗湖,入境,76586,27491,824,104901
2024-08-03,罗湖,出境,105501,32895,852,139248
2024-08-03,落马洲支线,入境,63854,34063,523,98440
2024-08-03,落马洲支线,出境,94236,29389,551,124176
2024-08-03,香园围,入境,31274,13058,158,44490
2024-08-03,香园围,出境,41357,8231,279,49867
2024-08-03,港珠澳大桥,入境,26082,12462,6736,45280
2024-08-03,港珠澳大桥,出境,47161,16428,5407,68996
2024-08-03,落马洲,入境,17067,4388,483,21938
2024-08-03,落马洲,出境,17851,6160,417,24428
2024-08-03,文锦渡,入境,1288,899,12,2199
2024-08-03,文锦渡,出境,1966,647,16,2629
2024-08-03,沙头角,入境,0,0,0,0
2024-08-03,沙头角,出境,0,0,0,0
2024-08-03,深圳湾,入境,35967,22603,1270,59840
2024-08-03,深圳湾,出境,53750,19285,1098,74133
2024-08-03,中国客运码头,入境,595,1174,161,1930
2024-08-03,中国客运码头,出境,1108,759,96,1963
2024-08-03,港口管制,入境,77,0,10,87
2024-08-03,港口管制,出境,0,0,25,25
2024-08-03,启德邮轮码头,入境,0,0,0,0
2024-08-03,启德邮轮码头,出境,0,0,0,0
2024-08-03,港澳客轮码头,入境,6175,2254,2526,10955
2024-08-03,港澳客轮码头,出境,9171,2849,2713,14733
2024-08-04,机场,入境,45842,12455,12235,70532
2024-08-04,机场,出境,35848,13642,17845,67335
2024-08-04,高铁西九龙,入境,27050,34215,1261,62526
2024-08-04,高铁西九龙,出境,15466,32705,1159,49330
2024-08-04,罗湖,入境,111164,23798,790,135752
2024-08-04,罗湖,出境,76553,32552,819,109924
2024-08-04,落马洲支线,入境,87690,26889,475,115054
2024-08-04,落马洲支线,出境,69581,28239,560,98380
2024-08-04,香园围,入境,41291,14756,207,56254
2024-08-04,香园围,出境,33786,7852,333,41971
2024-08-04,港珠澳大桥,入境,50952,11686,5748,68386
2024-08-04,港珠澳大桥,出境,29965,17253,5977,53195
2024-08-04,落马洲,入境,27272,3627,359,31258
2024-08-04,落马洲,出境,13181,6050,455,19686
2024-08-04,文锦渡,入境,1658,570,9,2237
2024-08-04,文锦渡,出境,1044,441,5,1490
2024-08-04,沙头角,入境,0,0,0,0
2024-08-04,沙头角,出境,0,0,0,0
2024-08-04,深圳湾,入境,61007,17482,1127,79616
2024-08-04,深圳湾,出境,39003,20458,1138,60599
2024-08-04,中国客运码头,入境,1340,927,124,2391
2024-08-04,中国客运码头,出境,548,994,113,1655
2024-08-04,港口管制,入境,0,0,30,30
2024-08-04,港口管制,出境,0,0,35,35
2024-08-04,启德邮轮码头,入境,0,0,0,0
2024-08-04,启德邮轮码头,出境,0,0,0,0
2024-08-04,港澳客轮码头,入境,9308,1997,1935,13240
2024-08-04,港澳客轮码头,出境,5948,2931,2492,11371
2024-08-05,机场,入境,42013,14184,13246,69443
2024-08-05,机场,出境,35014,13750,13887,62651
2024-08-05,高铁西九龙,入境,20067,28791,1288,50146
2024-08-05,高铁西九龙,出境,14882,24183,1234,40299
2024-08-05,罗湖,入境,69539,18852,741,89132
2024-08-05,罗湖,出境,61689,20379,825,82893
2024-08-05,落马洲支线,入境,53903,17193,387,71483
2024-08-05,落马洲支线,出境,50818,14788,392,65998
2024-08-05,香园围,入境,26248,10250,159,36657
2024-08-05,香园围,出境,24588,5146,228,29962
2024-08-05,港珠澳大桥,入境,30938,9824,3994,44756
2024-08-05,港珠澳大桥,出境,21739,17468,3562,42769
2024-08-05,落马洲,入境,15425,3975,352,19752
2024-08-05,落马洲,出境,8942,4158,539,13639
2024-08-05,文锦渡,入境,1319,468,12,1799
2024-08-05,文锦渡,出境,1301,358,10,1669
2024-08-05,沙头角,入境,0,0,0,0
2024-08-05,沙头角,出境,0,0,0,0
2024-08-05,深圳湾,入境,32039,14291,1079,47409
2024-08-05,深圳湾,出境,27642,13379,1254,42275
2024-08-05,中国客运码头,入境,656,862,72,1590
2024-08-05,中国客运码头,出境,629,785,113,1527
2024-08-05,港口管制,入境,3,0,31,34
2024-08-05,港口管制,出境,39,2,19,60
2024-08-05,启德邮轮码头,入境,0,0,0,0
2024-08-05,启德邮轮码头,出境,0,0,0,0
2024-08-05,港澳客轮码头,入境,6277,2079,1839,10195
2024-08-05,港澳客轮码头,出境,5063,3250,2335,10648
2024-08-06,机场,入境,40504,13073,12231,65808
2024-08-06,机场,出境,31268,12372,13186,56826
2024-08-06,高铁西九龙,入境,15393,25118,1198,41709
2024-08-06,高铁西九龙,出境,13873,21819,1171,36863
2024-08-06,罗湖,入境,60570,16344,630,77544
2024-08-06,罗湖,出境,59222,19206,723,79151
2024-08-06,落马洲支线,入境,47501,15744,392,63637
2024-08-06,落马洲支线,出境,47575,14361,385,62321
2024-08-06,香园围,入境,24100,10756,177,35033
2024-08-06,香园围,出境,23554,4930,266,28750
2024-08-06,港珠澳大桥,入境,21851,10561,3971,36383
2024-08-06,港珠澳大桥,出境,20327,17973,3635,41935
2024-08-06,落马洲,入境,10751,2974,358,14083
2024-08-06,落马洲,出境,8660,3663,444,12767
2024-08-06,文锦渡,入境,1210,370,5,1585
2024-08-06,文锦渡,出境,1259,275,3,1537
2024-08-06,沙头角,入境,0,0,0,0
2024-08-06,沙头角,出境,0,0,0,0
2024-08-06,深圳湾,入境,27949,13067,996,42012
2024-08-06,深圳湾,出境,25510,11880,937,38327
2024-08-06,中国客运码头,入境,529,754,72,1355
2024-08-06,中国客运码头,出境,558,717,90,1365
2024-08-06,港口管制,入境,64,0,46,110
2024-08-06,港口管制,出境,0,0,32,32
2024-08-06,启德邮轮码头,入境,0,0,0,0
2024-08-06,启德邮轮码头,出境,0,0,0,0
2024-08-06,港澳客轮码头,入境,5032,2007,1733,8772
2024-08-06,港澳客轮码头,出境,4578,3672,2040,10290
2024-08-07,机场,入境,37427,12974,13182,63583
2024-08-07,机场,出境,33311,12081,12604,57996
2024-08-07,高铁西九龙,入境,14745,24834,1178,40757
2024-08-07,高铁西九龙,出境,14548,22085,1216,37849
2024-08-07,罗湖,入境,62098,16662,606,79366
2024-08-07,罗湖,出境,62273,20573,649,83495
2024-08-07,落马洲支线,入境,49983,16341,439,66763
2024-08-07,落马洲支线,出境,52069,14809,449,67327
2024-08-07,香园围,入境,25011,10627,151,35789
2024-08-07,香园围,出境,25235,5030,151,30416
2024-08-07,港珠澳大桥,入境,21008,10186,4094,35288
2024-08-07,港珠澳大桥,出境,21027,16623,3895,41545
2024-08-07,落马洲,入境,10866,3080,338,14284
2024-08-07,落马洲,出境,9546,3982,397,13925
2024-08-07,文锦渡,入境,1292,473,6,1771
2024-08-07,文锦渡,出境,1316,371,5,1692
2024-08-07,沙头角,入境,0,0,0,0
2024-08-07,沙头角,出境,0,0,0,0
2024-08-07,深圳湾,入境,27589,12914,1165,41668
2024-08-07,深圳湾,出境,27258,12119,1000,40377
2024-08-07,中国客运码头,入境,511,809,84,1404
2024-08-07,中国客运码头,出境,505,746,124,1375
2024-08-07,港口管制,入境,6,0,32,38
2024-08-07,港口管制,出境,1,0,43,44
2024-08-07,启德邮轮码头,入境,0,0,0,0
2024-08-07,启德邮轮码头,出境,0,0,0,0
2024-08-07,港澳客轮码头,入境,5216,2353,1900,9469
2024-08-07,港澳客轮码头,出境,5358,3654,1984,10996
2024-08-08,机场,入境,34935,13308,15496,63739
2024-08-08,机场,出境,37595,11766,11894,61255
2024-08-08,高铁西九龙,入境,14332,24663,1308,40303
2024-08-08,高铁西九龙,出境,15871,22079,1137,39087
2024-08-08,罗湖,入境,63758,17019,728,81505
2024-08-08,罗湖,出境,63736,20220,728,84684
2024-08-08,落马洲支线,入境,49147,16901,389,66437
2024-08-08,落马洲支线,出境,51844,15078,392,67314
2024-08-08,香园围,入境,25130,10593,113,35836
2024-08-08,香园围,出境,25732,5342,192,31266
2024-08-08,港珠澳大桥,入境,20914,10021,4081,35016
2024-08-08,港珠澳大桥,出境,22314,17621,3969,43904
2024-08-08,落马洲,入境,11360,3223,421,15004
2024-08-08,落马洲,出境,9408,3780,348,13536
2024-08-08,文锦渡,入境,1253,515,6,1774
2024-08-08,文锦渡,出境,1361,355,13,1729
2024-08-08,沙头角,入境,0,0,0,0
2024-08-08,沙头角,出境,0,0,0,0
2024-08-08,深圳湾,入境,28039,14923,1121,44083
2024-08-08,深圳湾,出境,28780,12839,956,42575
2024-08-08,中国客运码头,入境,539,786,102,1427
2024-08-08,中国客运码头,出境,562,933,107,1602
2024-08-08,港口管制,入境,0,0,33,33
2024-08-08,港口管制,出境,0,0,22,22
2024-08-08,启德邮轮码头,入境,0,0,0,0
2024-08-08,启德邮轮码头,出境,0,0,0,0
2024-08-08,港澳客轮码头,入境,5249,2251,2037,9537
2024-08-08,港澳客轮码头,出境,5286,3424,2246,10956
2024-08-09,机场,入境,39165,13711,17205,70081
2024-08-09,机场,出境,41340,12494,12608,66442
2024-08-09,高铁西九龙,入境,14817,25903,1397,42117
2024-08-09,高铁西九龙,出境,23854,23069,1229,48152
2024-08-09,罗湖,入境,63773,17115,807,81695
2024-08-09,罗湖,出境,76092,21388,777,98257
2024-08-09,落马洲支线,入境,49827,17663,457,67947
2024-08-09,落马洲支线,出境,62253,16504,416,79173
2024-08-09,香园围,入境,25029,8714,153,33896
2024-08-09,香园围,出境,28218,5647,202,34067
2024-08-09,港珠澳大桥,入境,22092,10467,4353,36912
2024-08-09,港珠澳大桥,出境,32486,15579,3785,51850
2024-08-09,落马洲,入境,11608,3257,500,15365
2024-08-09,落马洲,出境,11764,4306,407,16477
2024-08-09,文锦渡,入境,1270,427,23,1720
2024-08-09,文锦渡,出境,1676,298,13,1987
2024-08-09,沙头角,入境,0,0,0,0
2024-08-09,沙头角,出境,0,0,0,0
2024-08-09,深圳湾,入境,28724,15000,1236,44960
2024-08-09,深圳湾,出境,37406,13667,982,52055
2024-08-09,中国客运码头,入境,631,787,129,1547
2024-08-09,中国客运码头,出境,890,877,67,1834
2024-08-09,港口管制,入境,2,0,8,10
2024-08-09,港口管制,出境,10,0,34,44
2024-08-09,启德邮轮码头,入境,0,0,0,0
2024-08-09,启德邮轮码头,出境,0,0,0,0
2024-08-09,港澳客轮码头,入境,5758,2080,2445,10283
2024-08-09,港澳客轮码头,出境,7011,3000,2328,12339
2024-08-10,机场,入境,40509,13324,16668,70501
2024-08-10,机场,出境,36090,12066,13695,61851
2024-08-10,高铁西九龙,入境,16207,39211,1496,56914
2024-08-10,高铁西九龙,出境,26835,28586,1153,56574
2024-08-10,罗湖,入境,78748,26438,805,105991
2024-08-10,罗湖,出境,109263,32629,775,142667
2024-08-10,落马洲支线,入境,64272,32478,576,97326
2024-08-10,落马洲支线,出境,96254,27908,487,124649
2024-08-10,香园围,入境,30099,13930,195,44224
2024-08-10,香园围,出境,40224,9010,214,49448
2024-08-10,港珠澳大桥,入境,25947,11792,5934,43673
2024-08-10,港珠澳大桥,出境,46988,16238,5213,68439
2024-08-10,落马洲,入境,17197,4276,488,21961
2024-08-10,落马洲,出境,18039,7185,433,25657
2024-08-10,文锦渡,入境,1303,752,18,2073
2024-08-10,文锦渡,出境,1792,483,8,2283
2024-08-10,沙头角,入境,0,0,0,0
2024-08-10,沙头角,出境,0,0,0,0
2024-08-10,深圳湾,入境,37712,22091,1397,61200
2024-08-10,深圳湾,出境,55459,20037,1046,76542
2024-08-10,中国客运码头,入境,502,1228,138,1868
2024-08-10,中国客运码头,出境,1346,771,167,2284
2024-08-10,港口管制,入境,1,0,35,36
2024-08-10,港口管制,出境,19,0,32,51
2024-08-10,启德邮轮码头,入境,0,0,0,0
2024-08-10,启德邮轮码头,出境,0,0,0,0
2024-08-10,港澳客轮码头,入境,6183,2332,2470,10985
2024-08-10,港澳客轮码头,出境,8703,2940,2535,14178
2024-08-11,机场,入境,50068,12421,13792,76281
2024-08-11,机场,出境,32210,14352,18771,65333
2024-08-11,高铁西九龙,入境,28508,32572,1308,62388
2024-08-11,高铁西九龙,出境,15138,32798,1409,49345
2024-08-11,罗湖,入境,115605,21996,798,138399
2024-08-11,罗湖,出境,77610,30398,783,108791
2024-08-11,落马洲支线,入境,90170,24240,456,114866
2024-08-11,落马洲支线,出境,70044,25125,483,95652
2024-08-11,香园围,入境,41274,13571,154,54999
2024-08-11,香园围,出境,33207,8800,347,42354
2024-08-11,港珠澳大桥,入境,51132,11276,5561,67969
2024-08-11,港珠澳大桥,出境,30473,15806,5724,52003
2024-08-11,落马洲,入境,28738,3428,398,32564
2024-08-11,落马洲,出境,13430,5400,426,19256
2024-08-11,文锦渡,入境,1799,532,9,2340
2024-08-11,文锦渡,出境,1246,476,3,1725
2024-08-11,沙头角,入境,0,0,0,0
2024-08-11,沙头角,出境,0,0,0,0
2024-08-11,深圳湾,入境,64732,16779,1099,82610
2024-08-11,深圳湾,出境,39990,21132,1142,62264
2024-08-11,中国客运码头,入境,1211,830,145,2186
2024-08-11,中国客运码头,出境,539,987,140,1666
2024-08-11,港口管制,入境,0,0,30,30
2024-08-11,港口管制,出境,0,0,45,45
2024-08-11,启德邮轮码头,入境,0,0,0,0
2024-08-11,启德邮轮码头,出境,0,0,0,0
2024-08-11,港澳客轮码头,入境,9145,1927,2187,13259
2024-08-11,港澳客轮码头,出境,6192,3018,2633,11843
2024-08-12,机场,入境,44612,14503,14246,73361
2024-08-12,机场,出境,30329,12237,17806,60372
2024-08-12,高铁西九龙,入境,21204,26306,1301,48811
2024-08-12,高铁西九龙,出境,14382,21762,1212,37356
2024-08-12,罗湖,入境,72645,18138,752,91535
2024-08-12,罗湖,出境,62734,19901,740,83375
2024-08-12,落马洲支线,入境,56461,16222,415,73098
2024-08-12,落马洲支线,出境,51561,14670,430,66661
2024-08-12,香园围,入境,26765,9846,177,36788
2024-08-12,香园围,出境,24572,4940,222,29734
2024-08-12,港珠澳大桥,入境,32162,9711,4270,46143
2024-08-12,港珠澳大桥,出境,21194,16653,3949,41796
2024-08-12,落马洲,入境,15329,3495,343,19167
2024-08-12,落马洲,出境,9141,3996,455,13592
2024-08-12,文锦渡,入境,1372,507,14,1893
2024-08-12,文锦渡,出境,1378,342,6,1726
2024-08-12,沙头角,入境,0,0,0,0
2024-08-12,沙头角,出境,0,0,0,0
2024-08-12,深圳湾,入境,35861,14279,1025,51165
2024-08-12,深圳湾,出境,28798,13792,1160,43750
2024-08-12,中国客运码头,入境,710,825,79,1614
2024-08-12,中国客运码头,出境,526,660,160,1346
2024-08-12,港口管制,入境,4,0,34,38
2024-08-12,港口管制,出境,79,0,20,99
2024-08-12,启德邮轮码头,入境,0,0,0,0
2024-08-12,启德邮轮码头,出境,0,0,0,0
2024-08-12,港澳客轮码头,入境,6390,1931,2062,10383
2024-08-12,港澳客轮码头,出境,4958,2544,2358,9860
2024-08-13,机场,入境,40743,12548,13498,66789
2024-08-13,机场,出境,27508,12047,14776,54331
2024-08-13,高铁西九龙,入境,17184,25476,1269,43929
2024-08-13,高铁西九龙,出境,13334,21038,1026,35398
2024-08-13,罗湖,入境,64910,16667,635,82212
2024-08-13,罗湖,出境,60762,19353,740,80855
2024-08-13,落马洲支线,入境,51572,16537,375,68484
2024-08-13,落马洲支线,出境,51343,15388,402,67133
2024-08-13,香园围,入境,26339,10414,193,36946
2024-08-13,香园围,出境,25863,5757,162,31782
2024-08-13,港珠澳大桥,入境,22822,10748,4346,37916
2024-08-13,港珠澳大桥,出境,20622,16348,4159,41129
2024-08-13,落马洲,入境,11655,3265,370,15290
2024-08-13,落马洲,出境,9294,4344,403,14041
2024-08-13,文锦渡,入境,1252,474,17,1743
2024-08-13,文锦渡,出境,1356,375,6,1737
2024-08-13,沙头角,入境,0,0,0,0
2024-08-13,沙头角,出境,0,0,0,0
2024-08-13,深圳湾,入境,31755,14247,1126,47128
2024-08-13,深圳湾,出境,26745,13148,1008,40901
2024-08-13,中国客运码头,入境,543,759,111,1413
2024-08-13,中国客运码头,出境,533,744,99,1376
2024-08-13,港口管制,入境,0,0,35,35
2024-08-13,港口管制,出境,5,4,30,39
2024-08-13,启德邮轮码头,入境,0,0,0,0
2024-08-13,启德邮轮码头,出境,0,0,0,0
2024-08-13,港澳客轮码头,入境,5175,1964,2116,9255
2024-08-13,港澳客轮码头,出境,4756,3035,2630,10421
2024-08-14,机场,入境,35690,13064,15610,64364
2024-08-14,机场,出境,30971,11579,13806,56356
2024-08-14,高铁西九龙,入境,15021,23098,1204,39323
2024-08-14,高铁西九龙,出境,13765,21548,1136,36449
2024-08-14,罗湖,入境,64583,16151,649,81383
2024-08-14,罗湖,出境,62305,19106,621,82032
2024-08-14,落马洲支线,入境,50270,15172,383,65825
2024-08-14,落马洲支线,出境,51895,14432,365,66692
2024-08-14,香园围,入境,25570,9667,266,35503
2024-08-14,香园围,出境,25218,5644,103,30965
2024-08-14,港珠澳大桥,入境,20841,9927,3913,34681
2024-08-14,港珠澳大桥,出境,20882,15740,3838,40460
2024-08-14,落马洲,入境,11335,3011,404,14750
2024-08-14,落马洲,出境,9490,4627,397,14514
2024-08-14,文锦渡,入境,1263,425,14,1702
2024-08-14,文锦渡,出境,1389,381,12,1782
2024-08-14,沙头角,入境,0,0,0,0
2024-08-14,沙头角,出境,0,0,0,0
2024-08-14,深圳湾,入境,28965,12895,999,42859
2024-08-14,深圳湾,出境,26773,12277,970,40020
2024-08-14,中国客运码头,入境,513,732,92,1337
2024-08-14,中国客运码头,出境,576,722,134,1432
2024-08-14,港口管制,入境,0,0,52,52
2024-08-14,港口管制,出境,0,0,61,61
2024-08-14,启德邮轮码头,入境,0,0,0,0
2024-08-14,启德邮轮码头,出境,0,0,0,0
2024-08-14,港澳客轮码头,入境,4870,1954,2295,9119
2024-08-14,港澳客轮码头,出境,4697,3210,2484,10391
2024-08-15,机场,入境,32147,13106,17000,62253
2024-08-15,机场,出境,34458,12037,13618,60113
2024-08-15,高铁西九龙,入境,15709,23210,1380,40299
2024-08-15,高铁西九龙,出境,15533,21720,1070,38323
2024-08-15,罗湖,入境,61666,15081,723,77470
2024-08-15,罗湖,出境,61656,18889,752,81297
2024-08-15,落马洲支线,入境,48403,14719,366,63488
2024-08-15,落马洲支线,出境,50422,15073,350,65845
2024-08-15,香园围,入境,24350,8097,135,32582
2024-08-15,香园围,出境,24717,4706,101,29524
2024-08-15,港珠澳大桥,入境,20195,9043,4364,33602
2024-08-15,港珠澳大桥,出境,20684,14593,4126,39403
2024-08-15,落马洲,入境,11376,2746,401,14523
2024-08-15,落马洲,出境,9190,3918,392,13500
2024-08-15,文锦渡,入境,1192,388,16,1596
2024-08-15,文锦渡,出境,1319,341,5,1665
2024-08-15,沙头角,入境,0,0,0,0
2024-08-15,沙头角,出境,0,0,0,0
2024-08-15,深圳湾,入境,27335,13113,1099,41547
2024-08-15,深圳湾,出境,27425,13077,807,41309
2024-08-15,中国客运码头,入境,550,818,113,1481
2024-08-15,中国客运码头,出境,492,841,105,1438
2024-08-15,港口管制,入境,0,0,52,52
2024-08-15,港口管制,出境,0,0,56,56
2024-08-15,启德邮轮码头,入境,0,0,0,0
2024-08-15,启德邮轮码头,出境,0,0,0,0
2024-08-15,港澳客轮码头,入境,4852,1831,2753,9436
2024-08-15,港澳客轮码头,出境,4798,3024,2710,10532
2024-08-16,机场,入境,34495,14826,17570,66891
2024-08-16,机场,出境,36126,12150,13888,62164
2024-08-16,高铁西九龙,入境,15266,23595,1603,40464
2024-08-16,高铁西九龙,出境,22397,21914,1181,45492
2024-08-16,罗湖,入境,63388,16756,685,80829
2024-08-16,罗湖,出境,75181,20850,742,96773
2024-08-16,落马洲支线,入境,50626,16098,430,67154
2024-08-16,落马洲支线,出境,62819,15859,412,79090
2024-08-16,香园围,入境,26058,7851,136,34045
2024-08-16,香园围,出境,29253,4748,247,34248
2024-08-16,港珠澳大桥,入境,21279,8348,4536,34163
2024-08-16,港珠澳大桥,出境,30965,12737,4066,47768
2024-08-16,落马洲,入境,11719,2859,509,15087
2024-08-16,落马洲,出境,11585,4136,394,16115
2024-08-16,文锦渡,入境,1265,447,7,1719
2024-08-16,文锦渡,出境,1568,422,10,2000
2024-08-16,沙头角,入境,0,0,0,0
2024-08-16,沙头角,出境,0,0,0,0
2024-08-16,深圳湾,入境,29724,14590,1172,45486
2024-08-16,深圳湾,出境,36232,13862,1078,51172
2024-08-16,中国客运码头,入境,606,758,161,1525
2024-08-16,中国客运码头,出境,869,809,136,1814
2024-08-16,港口管制,入境,2,7,71,80
2024-08-16,港口管制,出境,1,0,46,47
2024-08-16,启德邮轮码头,入境,0,0,0,0
2024-08-16,启德邮轮码头,出境,0,0,0,0
2024-08-16,港澳客轮码头,入境,5242,1767,2792,9801
2024-08-16,港澳客轮码头,出境,6542,2768,2939,12249
2024-08-17,机场,入境,34167,13899,14742,62808
2024-08-17,机场,出境,34830,11504,16968,63302
2024-08-17,高铁西九龙,入境,16048,34598,1492,52138
2024-08-17,高铁西九龙,出境,23841,27076,1257,52174
2024-08-17,罗湖,入境,69790,18858,750,89398
2024-08-17,罗湖,出境,95397,22877,816,119090
2024-08-17,落马洲支线,入境,59406,21921,442,81769
2024-08-17,落马洲支线,出境,84443,20319,449,105211
2024-08-17,香园围,入境,28037,9560,118,37715
2024-08-17,香园围,出境,34107,6269,170,40546
2024-08-17,港珠澳大桥,入境,23176,8639,5480,37295
2024-08-17,港珠澳大桥,出境,39825,12666,4683,57174
2024-08-17,落马洲,入境,15645,3389,513,19547
2024-08-17,落马洲,出境,16085,5224,365,21674
2024-08-17,文锦渡,入境,1212,529,12,1753
2024-08-17,文锦渡,出境,1599,441,16,2056
2024-08-17,沙头角,入境,0,0,0,0
2024-08-17,沙头角,出境,0,0,0,0
2024-08-17,深圳湾,入境,32826,17538,1145,51509
2024-08-17,深圳湾,出境,47455,16030,992,64477
2024-08-17,中国客运码头,入境,494,898,117,1509
2024-08-17,中国客运码头,出境,918,696,98,1712
2024-08-17,港口管制,入境,20,0,41,61
2024-08-17,港口管制,出境,0,0,55,55
2024-08-17,启德邮轮码头,入境,0,0,0,0
2024-08-17,启德邮轮码头,出境,0,0,0,0
2024-08-17,港澳客轮码头,入境,5226,1847,2877,9950
2024-08-17,港澳客轮码头,出境,7622,2358,3023,13003
2024-08-18,机场,入境,46583,13312,13559,73454
2024-08-18,机场,出境,33266,13134,20539,66939
2024-08-18,高铁西九龙,入境,27417,27718,1174,56309
2024-08-18,高铁西九龙,出境,14516,28747,1315,44578
2024-08-18,罗湖,入境,108065,18914,671,127650
2024-08-18,罗湖,出境,74395,23968,708,99071
2024-08-18,落马洲支线,入境,87293,21281,442,109016
2024-08-18,落马洲支线,出境,69540,20884,483,90907
2024-08-18,香园围,入境,40294,10074,180,50548
2024-08-18,香园围,出境,33070,6441,208,39719
2024-08-18,港珠澳大桥,入境,46249,9537,5415,61201
2024-08-18,港珠澳大桥,出境,28188,12633,5700,46521
2024-08-18,落马洲,入境,24478,3008,412,27898
2024-08-18,落马洲,出境,12671,6799,473,19943
2024-08-18,文锦渡,入境,1360,413,8,1781
2024-08-18,文锦渡,出境,1051,365,3,1419
2024-08-18,沙头角,入境,0,0,0,0
2024-08-18,沙头角,出境,0,0,0,0
2024-08-18,深圳湾,入境,59311,16082,981,76374
2024-08-18,深圳湾,出境,37960,17576,1121,56657
2024-08-18,中国客运码头,入境,1114,732,114,1960
2024-08-18,中国客运码头,出境,505,772,160,1437
2024-08-18,港口管制,入境,0,0,36,36
2024-08-18,港口管制,出境,1,0,50,51
2024-08-18,启德邮轮码头,入境,0,0,0,0
2024-08-18,启德邮轮码头,出境,0,0,0,0
2024-08-18,港澳客轮码头,入境,8447,1769,1932,12148
2024-08-18,港澳客轮码头,出境,5850,2409,2457,10716
2024-08-19,机场,入境,38805,14061,14349,67215
2024-08-19,机场,出境,32805,12364,15835,61004
2024-08-19,高铁西九龙,入境,20228,23524,1357,45109
2024-08-19,高铁西九龙,出境,14128,20707,1228,36063
2024-08-19,罗湖,入境,71112,16383,726,88221
2024-08-19,罗湖,出境,62666,17336,649,80651
2024-08-19,落马洲支线,入境,55091,14556,413,70060
2024-08-19,落马洲支线,出境,52126,12906,465,65497
2024-08-19,香园围,入境,27297,6959,165,34421
2024-08-19,香园围,出境,24902,4411,200,29513
2024-08-19,港珠澳大桥,入境,28811,7933,4530,41274
2024-08-19,港珠澳大桥,出境,21018,12576,4341,37935
2024-08-19,落马洲,入境,14790,3225,327,18342
2024-08-19,落马洲,出境,9174,5715,534,15423
2024-08-19,文锦渡,入境,1363,350,9,1722
2024-08-19,文锦渡,出境,1335,280,10,1625
2024-08-19,沙头角,入境,0,0,0,0
2024-08-19,沙头角,出境,0,0,0,0
2024-08-19,深圳湾,入境,33558,13148,993,47699
2024-08-19,深圳湾,出境,28442,12551,1025,42018
2024-08-19,中国客运码头,入境,757,723,76,1556
2024-08-19,中国客运码头,出境,657,639,116,1412
2024-08-19,港口管制,入境,1,2,13,16
2024-08-19,港口管制,出境,10,0,19,29
2024-08-19,启德邮轮码头,入境,0,0,0,0
2024-08-19,启德邮轮码头,出境,0,0,0,0
2024-08-19,港澳客轮码头,入境,6245,1419,1720,9384
2024-08-19,港澳客轮码头,出境,4635,2154,1925,8714
2024-08-20,机场,入境,35641,13203,12577,61421
2024-08-20,机场,出境,30129,11208,13972,55309
2024-08-20,高铁西九龙,入境,17230,22890,1248,41368
2024-08-20,高铁西九龙,出境,13297,19644,1169,34110
2024-08-20,罗湖,入境,64504,16608,609,81721
2024-08-20,罗湖,出境,60923,18726,636,80285
2024-08-20,落马洲支线,入境,50692,15994,379,67065
2024-08-20,落马洲支线,出境,50392,14543,403,65338
2024-08-20,香园围,入境,25321,9080,126,34527
2024-08-20,香园围,出境,25096,4416,158,29670
2024-08-20,港珠澳大桥,入境,21213,8525,4113,33851
2024-08-20,港珠澳大桥,出境,19783,12503,4039,36325
2024-08-20,落马洲,入境,11183,3257,336,14776
2024-08-20,落马洲,出境,9026,3605,365,12996
2024-08-20,文锦渡,入境,1420,498,26,1944
2024-08-20,文锦渡,出境,1372,378,4,1754
2024-08-20,沙头角,入境,0,0,0,0
2024-08-20,沙头角,出境,0,0,0,0
2024-08-20,深圳湾,入境,30656,13892,900,45448
2024-08-20,深圳湾,出境,26937,13640,1035,41612
2024-08-20,中国客运码头,入境,527,638,67,1232
2024-08-20,中国客运码头,出境,484,562,93,1139
2024-08-20,港口管制,入境,78,0,28,106
2024-08-20,港口管制,出境,0,7,39,46
2024-08-20,启德邮轮码头,入境,0,0,0,0
2024-08-20,启德邮轮码头,出境,0,0,0,0
2024-08-20,港澳客轮码头,入境,4430,1599,1678,7707
2024-08-20,港澳客轮码头,出境,4301,2191,1918,8410
2024-08-21,机场,入境,33539,14028,13831,61398
2024-08-21,机场,出境,33878,11212,13663,58753
2024-08-21,高铁西九龙,入境,15335,20709,1108,37152
2024-08-21,高铁西九龙,出境,13165,18368,1108,32641
2024-08-21,罗湖,入境,63398,14151,527,78076
2024-08-21,罗湖,出境,61802,16641,688,79131
2024-08-21,落马洲支线,入境,50656,14683,412,65751
2024-08-21,落马洲支线,出境,51779,13755,391,65925
2024-08-21,香园围,入境,25687,9593,114,35394
2024-08-21,香园围,出境,25214,4197,149,29560
2024-08-21,港珠澳大桥,入境,20277,8241,3886,32404
2024-08-21,港珠澳大桥,出境,20073,14306,3727,38106
2024-08-21,落马洲,入境,11204,2707,345,14256
2024-08-21,落马洲,出境,9322,3716,461,13499
2024-08-21,文锦渡,入境,1337,390,10,1737
2024-08-21,文锦渡,出境,1380,358,14,1752
2024-08-21,沙头角,入境,0,0,0,0
2024-08-21,沙头角,出境,0,0,0,0
2024-08-21,深圳湾,入境,28322,12692,972,41986
2024-08-21,深圳湾,出境,26716,11849,933,39498
2024-08-21,中国客运码头,入境,500,679,79,1258
2024-08-21,中国客运码头,出境,484,699,127,1310
2024-08-21,港口管制,入境,0,0,49,49
2024-08-21,港口管制,出境,0,0,27,27
2024-08-21,启德邮轮码头,入境,0,0,0,0
2024-08-21,启德邮轮码头,出境,0,0,0,0
2024-08-21,港澳客轮码头,入境,4584,1518,1597,7699
2024-08-21,港澳客轮码头,出境,4476,2605,1937,9018
2024-08-22,机场,入境,30304,14305,15045,59654
2024-08-22,机场,出境,37028,10588,12436,60052
2024-08-22,高铁西九龙,入境,16147,24272,1284,41703
2024-08-22,高铁西九龙,出境,14991,20734,1091,36816
2024-08-22,罗湖,入境,66150,17452,610,84212
2024-08-22,罗湖,出境,64661,19951,741,85353
2024-08-22,落马洲支线,入境,51829,18276,458,70563
2024-08-22,落马洲支线,出境,54344,15935,420,70699
2024-08-22,香园围,入境,28368,9467,190,38025
2024-08-22,香园围,出境,28284,5019,131,33434
2024-08-22,港珠澳大桥,入境,21015,8912,4228,34155
2024-08-22,港珠澳大桥,出境,22012,15737,3820,41569
2024-08-22,落马洲,入境,11743,3006,355,15104
2024-08-22,落马洲,出境,9854,3777,353,13984
2024-08-22,文锦渡,入境,1384,520,17,1921
2024-08-22,文锦渡,出境,1494,392,8,1894
2024-08-22,沙头角,入境,0,0,0,0
2024-08-22,沙头角,出境,0,0,0,0
2024-08-22,深圳湾,入境,29920,14917,962,45799
2024-08-22,深圳湾,出境,29742,13042,866,43650
2024-08-22,中国客运码头,入境,531,728,134,1393
2024-08-22,中国客运码头,出境,527,697,127,1351
2024-08-22,港口管制,入境,0,0,125,125
2024-08-22,港口管制,出境,1,0,41,42
2024-08-22,启德邮轮码头,入境,11,17,3477,3505
2024-08-22,启德邮轮码头,出境,86,60,1503,1649
2024-08-22,港澳客轮码头,入境,4892,1851,2127,8870
2024-08-22,港澳客轮码头,出境,4732,2435,2006,9173
2024-08-23,机场,入境,32825,15750,17843,66418
2024-08-23,机场,出境,41459,11592,12674,65725
2024-08-23,高铁西九龙,入境,16901,30116,1579,48596
2024-08-23,高铁西九龙,出境,21942,23360,1097,46399
2024-08-23,罗湖,入境,68334,20115,683,89132
2024-08-23,罗湖,出境,78354,23991,720,103065
2024-08-23,落马洲支线,入境,53965,20130,500,74595
2024-08-23,落马洲支线,出境,66686,18816,484,85986
2024-08-23,香园围,入境,28668,9609,171,38448
2024-08-23,香园围,出境,31674,5491,208,37373
2024-08-23,港珠澳大桥,入境,22368,9663,4441,36472
2024-08-23,港珠澳大桥,出境,33266,14284,4171,51721
2024-08-23,落马洲,入境,12267,3666,498,16431
2024-08-23,落马洲,出境,12057,5168,397,17622
2024-08-23,文锦渡,入境,1319,575,12,1906
2024-08-23,文锦渡,出境,1689,468,6,2163
2024-08-23,沙头角,入境,0,0,0,0
2024-08-23,沙头角,出境,0,0,0,0
2024-08-23,深圳湾,入境,32548,17535,1060,51143
2024-08-23,深圳湾,出境,38842,15739,900,55481
2024-08-23,中国客运码头,入境,565,923,155,1643
2024-08-23,中国客运码头,出境,886,854,133,1873
2024-08-23,港口管制,入境,3,0,30,33
2024-08-23,港口管制,出境,0,0,26,26
2024-08-23,启德邮轮码头,入境,0,0,0,0
2024-08-23,启德邮轮码头,出境,4,1,2024,2029
2024-08-23,港澳客轮码头,入境,5332,1985,2150,9467
2024-08-23,港澳客轮码头,出境,6782,2356,2263,11401
2024-08-24,机场,入境,36205,13730,16297,66232
2024-08-24,机场,出境,37403,12049,14087,63539
2024-08-24,高铁西九龙,入境,17103,37774,1407,56284
2024-08-24,高铁西九龙,出境,25084,29989,1052,56125
2024-08-24,罗湖,入境,83687,26871,767,111325
2024-08-24,罗湖,出境,114770,33772,783,149325
2024-08-24,落马洲支线,入境,69571,33053,548,103172
2024-08-24,落马洲支线,出境,103405,30371,563,134339
2024-08-24,香园围,入境,34346,12180,172,46698
2024-08-24,香园围,出境,44868,7896,297,53061
2024-08-24,港珠澳大桥,入境,26644,11147,6578,44369
2024-08-24,港珠澳大桥,出境,49126,15562,5730,70418
2024-08-24,落马洲,入境,18101,4310,449,22860
2024-08-24,落马洲,出境,19279,8166,417,27862
2024-08-24,文锦渡,入境,1379,682,10,2071
2024-08-24,文锦渡,出境,2150,529,5,2684
2024-08-24,沙头角,入境,0,0,0,0
2024-08-24,沙头角,出境,0,0,0,0
2024-08-24,深圳湾,入境,39986,22731,1362,64079
2024-08-24,深圳湾,出境,56954,21677,1172,79803
2024-08-24,中国客运码头,入境,477,1218,137,1832
2024-08-24,中国客运码头,出境,1025,836,113,1974
2024-08-24,港口管制,入境,1,0,26,27
2024-08-24,港口管制,出境,1,0,47,48
2024-08-24,启德邮轮码头,入境,0,0,0,0
2024-08-24,启德邮轮码头,出境,0,0,0,0
2024-08-24,港澳客轮码头,入境,6045,2079,2685,10809
2024-08-24,港澳客轮码头,出境,8967,2589,2948,14504
2024-08-25,机场,入境,47430,12950,14149,74529
2024-08-25,机场,出境,34015,13747,19109,66871
2024-08-25,高铁西九龙,入境,30197,32148,1199,63544
2024-08-25,高铁西九龙,出境,15062,33437,1368,49867
2024-08-25,罗湖,入境,121918,22598,782,145298
2024-08-25,罗湖,出境,82968,30809,807,114584
2024-08-25,落马洲支线,入境,96140,25986,460,122586
2024-08-25,落马洲支线,出境,74821,27114,506,102441
2024-08-25,香园围,入境,46383,11765,143,58291
2024-08-25,香园围,出境,37708,8418,195,46321
2024-08-25,港珠澳大桥,入境,53532,10896,5662,70090
2024-08-25,港珠澳大桥,出境,32636,14242,6313,53191
2024-08-25,落马洲,入境,30807,3750,370,34927
2024-08-25,落马洲,出境,15183,7029,521,22733
2024-08-25,文锦渡,入境,1897,619,10,2526
2024-08-25,文锦渡,出境,1195,526,9,1730
2024-08-25,沙头角,入境,0,0,0,0
2024-08-25,沙头角,出境,0,0,0,0
2024-08-25,深圳湾,入境,67232,18821,1058,87111
2024-08-25,深圳湾,出境,42943,22474,1259,66676
2024-08-25,中国客运码头,入境,1281,1035,138,2454
2024-08-25,中国客运码头,出境,448,978,216,1642
2024-08-25,港口管制,入境,42,0,23,65
2024-08-25,港口管制,出境,35,1,18,54
2024-08-25,启德邮轮码头,入境,0,0,0,0
2024-08-25,启德邮轮码头,出境,0,0,0,0
2024-08-25,港澳客轮码头,入境,9381,1789,2179,13349
2024-08-25,港澳客轮码头,出境,6687,2441,2838,11966
2024-08-26,机场,入境,44043,12953,13889,70885
2024-08-26,机场,出境,31658,11711,17576,60945
2024-08-26,高铁西九龙,入境,22316,24654,1200,48170
2024-08-26,高铁西九龙,出境,13917,23709,1339,38965
2024-08-26,罗湖,入境,77894,18075,715,96684
2024-08-26,罗湖,出境,67051,21151,707,88909
2024-08-26,落马洲支线,入境,61124,17898,431,79453
2024-08-26,落马洲支线,出境,56483,15877,415,72775
2024-08-26,香园围,入境,30354,7501,184,38039
2024-08-26,香园围,出境,27868,4297,207,32372
2024-08-26,港珠澳大桥,入境,33737,7910,4186,45833
2024-08-26,港珠澳大桥,出境,23206,12792,4220,40218
2024-08-26,落马洲,入境,15781,3644,351,19776
2024-08-26,落马洲,出境,9451,4432,575,14458
2024-08-26,文锦渡,入境,1431,569,7,2007
2024-08-26,文锦渡,出境,1397,428,3,1828
2024-08-26,沙头角,入境,0,0,0,0
2024-08-26,沙头角,出境,0,0,0,0
2024-08-26,深圳湾,入境,38288,15380,935,54603
2024-08-26,深圳湾,出境,30490,15223,1192,46905
2024-08-26,中国客运码头,入境,697,802,262,1761
2024-08-26,中国客运码头,出境,555,804,164,1523
2024-08-26,港口管制,入境,0,0,55,55
2024-08-26,港口管制,出境,0,0,44,44
2024-08-26,启德邮轮码头,入境,0,0,0,0
2024-08-26,启德邮轮码头,出境,0,0,0,0
2024-08-26,港澳客轮码头,入境,6753,1637,1977,10367
2024-08-26,港澳客轮码头,出境,5286,2357,2456,10099
2024-08-27,机场,入境,37558,11166,11979,60703
2024-08-27,机场,出境,27316,10554,14347,52217
2024-08-27,高铁西九龙,入境,18018,21616,1224,40858
2024-08-27,高铁西九龙,出境,13760,22193,1102,37055
2024-08-27,罗湖,入境,69360,16651,587,86598
2024-08-27,罗湖,出境,66100,20656,645,87401
2024-08-27,落马洲支线,入境,55102,16133,343,71578
2024-08-27,落马洲支线,出境,54567,15786,377,70730
2024-08-27,香园围,入境,28089,7110,166,35365
2024-08-27,香园围,出境,27560,4183,330,32073
2024-08-27,港珠澳大桥,入境,23740,7740,3761,35241
2024-08-27,港珠澳大桥,出境,21666,10814,3722,36202
2024-08-27,落马洲,入境,12002,2985,319,15306
2024-08-27,落马洲,出境,9706,3901,394,14001
2024-08-27,文锦渡,入境,1468,517,15,2000
2024-08-27,文锦渡,出境,1424,422,4,1850
2024-08-27,沙头角,入境,0,0,0,0
2024-08-27,沙头角,出境,0,0,0,0
2024-08-27,深圳湾,入境,32747,14759,951,48457
2024-08-27,深圳湾,出境,28591,15027,1046,44664
2024-08-27,中国客运码头,入境,565,865,66,1496
2024-08-27,中国客运码头,出境,600,762,125,1487
2024-08-27,港口管制,入境,0,2,44,46
2024-08-27,港口管制,出境,0,0,17,17
2024-08-27,启德邮轮码头,入境,0,0,0,0
2024-08-27,启德邮轮码头,出境,0,0,0,0
2024-08-27,港澳客轮码头,入境,5645,1590,1797,9032
2024-08-27,港澳客轮码头,出境,4890,2068,2185,9143
2024-08-28,机场,入境,37173,10979,12566,60718
2024-08-28,机场,出境,28310,10186,13741,52237
2024-08-28,高铁西九龙,入境,17271,20400,1172,38843
2024-08-28,高铁西九龙,出境,13814,22072,1167,37053
2024-08-28,罗湖,入境,69465,15435,597,85497
2024-08-28,罗湖,出境,66612,19286,654,86552
2024-08-28,落马洲支线,入境,54552,15436,370,70358
2024-08-28,落马洲支线,出境,56121,15563,368,72052
2024-08-28,香园围,入境,27143,6154,155,33452
2024-08-28,香园围,出境,27702,4327,124,32153
2024-08-28,港珠澳大桥,入境,22774,6646,3551,32971
2024-08-28,港珠澳大桥,出境,22900,10502,3755,37157
2024-08-28,落马洲,入境,11729,2857,409,14995
2024-08-28,落马洲,出境,10163,4248,420,14831
2024-08-28,文锦渡,入境,1347,484,11,1842
2024-08-28,文锦渡,出境,1390,387,7,1784
2024-08-28,沙头角,入境,0,0,0,0
2024-08-28,沙头角,出境,0,0,0,0
2024-08-28,深圳湾,入境,31436,13526,972,45934
2024-08-28,深圳湾,出境,29281,14113,944,44338
2024-08-28,中国客运码头,入境,551,644,111,1306
2024-08-28,中国客运码头,出境,536,794,108,1438
2024-08-28,港口管制,入境,2,0,44,46
2024-08-28,港口管制,出境,2,0,67,69
2024-08-28,启德邮轮码头,入境,0,0,0,0
2024-08-28,启德邮轮码头,出境,0,0,0,0
2024-08-28,港澳客轮码头,入境,5376,1503,1636,8515
2024-08-28,港澳客轮码头,出境,5320,2016,1993,9329
2024-08-29,机场,入境,35926,10132,13420,59478
2024-08-29,机场,出境,27523,9579,12893,49995
2024-08-29,高铁西九龙,入境,17378,18027,1272,36677
2024-08-29,高铁西九龙,出境,14406,20578,1097,36081
2024-08-29,罗湖,入境,70066,13829,606,84501
2024-08-29,罗湖,出境,67188,18078,654,85920
2024-08-29,落马洲支线,入境,54660,13926,402,68988
2024-08-29,落马洲支线,出境,56462,14760,307,71529
2024-08-29,香园围,入境,28548,5093,329,33970
2024-08-29,香园围,出境,28298,3808,175,32281
2024-08-29,港珠澳大桥,入境,22551,5433,3418,31402
2024-08-29,港珠澳大桥,出境,23309,9080,3762,36151
2024-08-29,落马洲,入境,12438,2498,372,15308
2024-08-29,落马洲,出境,9934,3740,357,14031
2024-08-29,文锦渡,入境,1432,397,34,1863
2024-08-29,文锦渡,出境,1408,402,18,1828
2024-08-29,沙头角,入境,0,0,0,0
2024-08-29,沙头角,出境,0,0,0,0
2024-08-29,深圳湾,入境,31550,12075,1047,44672
2024-08-29,深圳湾,出境,29370,12948,843,43161
2024-08-29,中国客运码头,入境,623,623,90,1336
2024-08-29,中国客运码头,出境,540,651,116,1307
2024-08-29,港口管制,入境,0,0,50,50
2024-08-29,港口管制,出境,1,0,65,66
2024-08-29,启德邮轮码头,入境,0,0,0,0
2024-08-29,启德邮轮码头,出境,0,0,0,0
2024-08-29,港澳客轮码头,入境,5408,1353,1698,8459
2024-08-29,港澳客轮码头,出境,5441,1772,2030,9243
2024-08-30,机场,入境,37168,9210,15189,61567
2024-08-30,机场,出境,30545,10657,12220,53422
2024-08-30,高铁西九龙,入境,17858,17334,1419,36611
2024-08-30,高铁西九龙,出境,21282,19039,1051,41372
2024-08-30,罗湖,入境,73238,13997,628,87863
2024-08-30,罗湖,出境,80529,18105,673,99307
2024-08-30,落马洲支线,入境,57058,14984,420,72462
2024-08-30,落马洲支线,出境,67901,15095,361,83357
2024-08-30,香园围,入境,28811,4378,107,33296
2024-08-30,香园围,出境,32019,4093,371,36483
2024-08-30,港珠澳大桥,入境,24084,5752,4020,33856
2024-08-30,港珠澳大桥,出境,34174,7348,4098,45620
2024-08-30,落马洲,入境,13024,2635,543,16202
2024-08-30,落马洲,出境,11987,3522,328,15837
2024-08-30,文锦渡,入境,1307,447,13,1767
2024-08-30,文锦渡,出境,1488,419,13,1920
2024-08-30,沙头角,入境,0,0,0,0
2024-08-30,沙头角,出境,0,0,0,0
2024-08-30,深圳湾,入境,32487,12515,1269,46271
2024-08-30,深圳湾,出境,37477,13052,816,51345
2024-08-30,中国客运码头,入境,588,528,141,1257
2024-08-30,中国客运码头,出境,736,657,133,1526
2024-08-30,港口管制,入境,0,0,36,36
2024-08-30,港口管制,出境,2,0,40,42
2024-08-30,启德邮轮码头,入境,0,0,0,0
2024-08-30,启德邮轮码头,出境,0,0,0,0
2024-08-30,港澳客轮码头,入境,5971,1089,2169,9229
2024-08-30,港澳客轮码头,出境,8221,1462,2216,11899
2024-08-31,机场,入境,40475,7715,13956,62146
2024-08-31,机场,出境,28124,8830,13241,50195
2024-08-31,高铁西九龙,入境,20015,23404,1328,44747
2024-08-31,高铁西九龙,出境,22309,22804,1107,46220
2024-08-31,罗湖,入境,89580,16553,723,106856
2024-08-31,罗湖,出境,107507,21498,742,129747
2024-08-31,落马洲支线,入境,73548,21694,409,95651
2024-08-31,落马洲支线,出境,95062,20819,426,116307
2024-08-31,香园围,入境,35464,6394,174,42032
2024-08-31,香园围,出境,42544,5033,277,47854
2024-08-31,港珠澳大桥,入境,30959,4950,5353,41262
2024-08-31,港珠澳大桥,出境,42356,6837,5087,54280
2024-08-31,落马洲,入境,19116,2666,453,22235
2024-08-31,落马洲,出境,18154,3894,345,22393
2024-08-31,文锦渡,入境,1479,560,10,2049
2024-08-31,文锦渡,出境,1987,480,4,2471
2024-08-31,沙头角,入境,0,0,0,0
2024-08-31,沙头角,出境,0,0,0,0
2024-08-31,深圳湾,入境,42883,15281,1084,59248
2024-08-31,深圳湾,出境,50100,15511,798,66409
2024-08-31,中国客运码头,入境,555,651,101,1307
2024-08-31,中国客运码头,出境,865,537,114,1516
2024-08-31,港口管制,入境,0,2,19,21
2024-08-31,港口管制,出境,1,0,15,16
2024-08-31,启德邮轮码头,入境,0,0,0,0
2024-08-31,启德邮轮码头,出境,0,0,0,0
2024-08-31,港澳客轮码头,入境,6939,1050,2459,10448
2024-08-31,港澳客轮码头,出境,9225,1198,2617,13040
2024-09-01,机场,入境,44473,7745,13568,65786
2024-09-01,机场,出境,28208,9640,16087,53935
2024-09-01,高铁西九龙,入境,28995,14925,1184,45104
2024-09-01,高铁西九龙,出境,11652,19964,1372,32988
2024-09-01,罗湖,入境,111168,13182,587,124937
2024-09-01,罗湖,出境,70808,16817,627,88252
2024-09-01,落马洲支线,入境,87798,17234,434,105466
2024-09-01,落马洲支线,出境,60152,17409,472,78033
2024-09-01,香园围,入境,44418,5398,185,50001
2024-09-01,香园围,出境,32411,3827,246,36484
2024-09-01,港珠澳大桥,入境,50485,4566,4501,59552
2024-09-01,港珠澳大桥,出境,22174,5553,5534,33261
2024-09-01,落马洲,入境,27350,2398,403,30151
2024-09-01,落马洲,出境,13691,3141,515,17347
2024-09-01,文锦渡,入境,1956,466,14,2436
2024-09-01,文锦渡,出境,1099,378,5,1482
2024-09-01,沙头角,入境,0,0,0,0
2024-09-01,沙头角,出境,0,0,0,0
2024-09-01,深圳湾,入境,60468,11466,969,72903
2024-09-01,深圳湾,出境,33367,12728,1126,47221
2024-09-01,中国客运码头,入境,1109,310,20,1439
2024-09-01,中国客运码头,出境,365,421,28,814
2024-09-01,港口管制,入境,29,0,14,43
2024-09-01,港口管制,出境,1,0,20,21
2024-09-01,启德邮轮码头,入境,0,0,0,0
2024-09-01,启德邮轮码头,出境,0,0,0,0
2024-09-01,港澳客轮码头,入境,10826,844,1573,13243
2024-09-01,港澳客轮码头,出境,5266,1144,2475,8885
2024-09-02,机场,入境,30025,8628,15950,54603
2024-09-02,机场,出境,24742,7236,12314,44292
2024-09-02,高铁西九龙,入境,14286,11709,965,26960
2024-09-02,高铁西九龙,出境,11446,10332,1136,22914
2024-09-02,罗湖,入境,64923,10968,551,76442
2024-09-02,罗湖,出境,60485,11410,608,72503
2024-09-02,落马洲支线,入境,51701,11684,299,63684
2024-09-02,落马洲支线,出境,50800,10573,374,61747
2024-09-02,香园围,入境,27089,4209,99,31397
2024-09-02,香园围,出境,26233,2673,265,29171
2024-09-02,港珠澳大桥,入境,19666,3504,2844,26014
2024-09-02,港珠澳大桥,出境,16270,4292,2773,23335
2024-09-02,落马洲,入境,12041,2750,288,15079
2024-09-02,落马洲,出境,8579,2825,538,11942
2024-09-02,文锦渡,入境,2045,482,5,2532
2024-09-02,文锦渡,出境,2086,349,7,2442
2024-09-02,沙头角,入境,0,0,0,0
2024-09-02,沙头角,出境,0,0,0,0
2024-09-02,深圳湾,入境,28770,9210,749,38729
2024-09-02,深圳湾,出境,26111,7893,933,34937
2024-09-02,中国客运码头,入境,454,267,82,803
2024-09-02,中国客运码头,出境,463,217,47,727
2024-09-02,港口管制,入境,1,1,62,64
2024-09-02,港口管制,出境,0,0,27,27
2024-09-02,启德邮轮码头,入境,0,0,0,0
2024-09-02,启德邮轮码头,出境,0,0,0,0
2024-09-02,港澳客轮码头,入境,5497,722,1707,7926
2024-09-02,港澳客轮码头,出境,4210,850,1959,7019
2024-09-03,机场,入境,22543,7875,16292,46710
2024-09-03,机场,出境,22950,6631,11877,41458
2024-09-03,高铁西九龙,入境,11549,12002,1205,24756
2024-09-03,高铁西九龙,出境,11883,10186,1097,23166
2024-09-03,罗湖,入境,60494,10251,559,71304
2024-09-03,罗湖,出境,61347,11256,617,73220
2024-09-03,落马洲支线,入境,48483,11157,323,59963
2024-09-03,落马洲支线,出境,49989,10562,304,60855
2024-09-03,香园围,入境,25936,4519,106,30561
2024-09-03,香园围,出境,26126,2492,237,28855
2024-09-03,港珠澳大桥,入境,16115,3547,2895,22557
2024-09-03,港珠澳大桥,出境,16381,5615,3513,25509
2024-09-03,落马洲,入境,9489,2248,343,12080
2024-09-03,落马洲,出境,8633,2288,428,11349
2024-09-03,文锦渡,入境,1949,368,11,2328
2024-09-03,文锦渡,出境,2096,342,11,2449
2024-09-03,沙头角,入境,0,0,0,0
2024-09-03,沙头角,出境,0,0,0,0
2024-09-03,深圳湾,入境,25376,9510,892,35778
2024-09-03,深圳湾,出境,25999,7919,951,34869
2024-09-03,中国客运码头,入境,289,252,44,585
2024-09-03,中国客运码头,出境,372,244,45,661
2024-09-03,港口管制,入境,0,0,37,37
2024-09-03,港口管制,出境,0,0,47,47
2024-09-03,启德邮轮码头,入境,0,0,0,0
2024-09-03,启德邮轮码头,出境,0,0,0,0
2024-09-03,港澳客轮码头,入境,4536,821,1735,7092
2024-09-03,港澳客轮码头,出境,4048,1070,2174,7292
2024-09-04,机场,入境,20617,6674,13345,40636
2024-09-04,机场,出境,24866,6517,11795,43178
2024-09-04,高铁西九龙,入境,11426,11876,985,24287
2024-09-04,高铁西九龙,出境,12261,11024,1121,24406
2024-09-04,罗湖,入境,60750,10594,586,71930
2024-09-04,罗湖,出境,61350,11938,648,73936
2024-09-04,落马洲支线,入境,48414,11715,330,60459
2024-09-04,落马洲支线,出境,49995,11535,342,61872
2024-09-04,香园围,入境,25370,4905,156,30431
2024-09-04,香园围,出境,25536,2852,132,28520
2024-09-04,港珠澳大桥,入境,15704,3583,3003,22290
2024-09-04,港珠澳大桥,出境,15127,5951,2559,23637
2024-09-04,落马洲,入境,9398,2413,322,12133
2024-09-04,落马洲,出境,8451,2669,380,11500
2024-09-04,文锦渡,入境,1973,390,10,2373
2024-09-04,文锦渡,出境,2154,348,12,2514
2024-09-04,沙头角,入境,0,0,0,0
2024-09-04,沙头角,出境,0,0,0,0
2024-09-04,深圳湾,入境,25955,9544,898,36397
2024-09-04,深圳湾,出境,25972,8514,936,35422
2024-09-04,中国客运码头,入境,368,342,36,746
2024-09-04,中国客运码头,出境,356,267,37,660
2024-09-04,港口管制,入境,0,0,61,61
2024-09-04,港口管制,出境,33,1,39,73
2024-09-04,启德邮轮码头,入境,0,0,0,0
2024-09-04,启德邮轮码头,出境,0,0,0,0
2024-09-04,港澳客轮码头,入境,3680,707,1463,5850
2024-09-04,港澳客轮码头,出境,3311,1223,2083,6617
2024-09-05,机场,入境,18108,6732,12724,37564
2024-09-05,机场,出境,28218,6974,12541,47733
2024-09-05,高铁西九龙,入境,10700,10392,1169,22261
2024-09-05,高铁西九龙,出境,14634,11318,1246,27198
2024-09-05,罗湖,入境,42066,8958,564,51588
2024-09-05,罗湖,出境,49824,11300,669,61793
2024-09-05,落马洲支线,入境,34426,9726,309,44461
2024-09-05,落马洲支线,出境,41915,10949,327,53191
2024-09-05,香园围,入境,15168,5096,210,20474
2024-09-05,香园围,出境,17777,2714,171,20662
2024-09-05,港珠澳大桥,入境,10146,3249,2620,16015
2024-09-05,港珠澳大桥,出境,9766,5239,2020,17025
2024-09-05,落马洲,入境,7516,1913,424,9853
2024-09-05,落马洲,出境,7138,2198,431,9767
2024-09-05,文锦渡,入境,1686,308,8,2002
2024-09-05,文锦渡,出境,1728,271,8,2007
2024-09-05,沙头角,入境,0,0,0,0
2024-09-05,沙头角,出境,0,0,0,0
2024-09-05,深圳湾,入境,17532,7700,1005,26237
2024-09-05,深圳湾,出境,21910,8092,962,30964
2024-09-05,中国客运码头,入境,0,0,0,0
2024-09-05,中国客运码头,出境,0,0,0,0
2024-09-05,港口管制,入境,0,0,13,13
2024-09-05,港口管制,出境,1,0,12,13
2024-09-05,启德邮轮码头,入境,0,0,0,0
2024-09-05,启德邮轮码头,出境,0,0,0,0
2024-09-05,港澳客轮码头,入境,1659,411,972,3042
2024-09-05,港澳客轮码头,出境,1029,528,1028,2585
2024-09-06,机场,入境,19831,5871,12957,38659
2024-09-06,机场,出境,27310,5739,14388,47437
2024-09-06,高铁西九龙,入境,9313,10474,1299,21086
2024-09-06,高铁西九龙,出境,15644,8776,1193,25613
2024-09-06,罗湖,入境,40299,6051,477,46827
2024-09-06,罗湖,出境,48268,6906,517,55691
2024-09-06,落马洲支线,入境,27668,5891,285,33844
2024-09-06,落马洲支线,出境,35415,5477,238,41130
2024-09-06,香园围,入境,12872,2279,97,15248
2024-09-06,香园围,出境,14224,2168,136,16528
2024-09-06,港珠澳大桥,入境,5521,1742,2818,10081
2024-09-06,港珠澳大桥,出境,13549,3630,1975,19154
2024-09-06,落马洲,入境,5582,1536,519,7637
2024-09-06,落马洲,出境,6775,1695,333,8803
2024-09-06,文锦渡,入境,512,121,3,636
2024-09-06,文锦渡,出境,695,122,12,829
2024-09-06,沙头角,入境,0,0,0,0
2024-09-06,沙头角,出境,0,0,0,0
2024-09-06,深圳湾,入境,13685,4778,1012,19475
2024-09-06,深圳湾,出境,17369,4654,741,22764
2024-09-06,中国客运码头,入境,0,0,0,0
2024-09-06,中国客运码头,出境,0,0,0,0
2024-09-06,港口管制,入境,0,0,10,10
2024-09-06,港口管制,出境,0,0,4,4
2024-09-06,启德邮轮码头,入境,0,0,0,0
2024-09-06,启德邮轮码头,出境,0,0,0,0
2024-09-06,港澳客轮码头,入境,1115,218,901,2234
2024-09-06,港澳客轮码头,出境,2448,337,706,3491
2024-09-07,机场,入境,26186,7458,14903,48547
2024-09-07,机场,出境,28754,7001,16829,52584
2024-09-07,高铁西九龙,入境,12725,16635,1212,30572
2024-09-07,高铁西九龙,出境,20576,12561,1164,34301
2024-09-07,罗湖,入境,76184,12136,673,88993
2024-09-07,罗湖,出境,102038,13383,713,116134
2024-09-07,落马洲支线,入境,60335,14836,393,75564
2024-09-07,落马洲支线,出境,85177,13539,367,99083
2024-09-07,香园围,入境,31314,4884,163,36361
2024-09-07,香园围,出境,39200,3028,112,42340
2024-09-07,港珠澳大桥,入境,19752,4386,5494,29632
2024-09-07,港珠澳大桥,出境,35446,5871,4040,45357
2024-09-07,落马洲,入境,15233,2193,433,17859
2024-09-07,落马洲,出境,15844,5158,382,21384
2024-09-07,文锦渡,入境,1275,394,10,1679
2024-09-07,文锦渡,出境,1988,357,11,2356
2024-09-07,沙头角,入境,0,0,0,0
2024-09-07,沙头角,出境,0,0,0,0
2024-09-07,深圳湾,入境,33573,11924,1023,46520
2024-09-07,深圳湾,出境,46824,11278,816,58918
2024-09-07,中国客运码头,入境,246,199,33,478
2024-09-07,中国客运码头,出境,377,159,15,551
2024-09-07,港口管制,入境,0,0,22,22
2024-09-07,港口管制,出境,1,0,54,55
2024-09-07,启德邮轮码头,入境,0,0,0,0
2024-09-07,启德邮轮码头,出境,0,0,0,0
2024-09-07,港澳客轮码头,入境,4225,694,2074,6993
2024-09-07,港澳客轮码头,出境,7218,964,2279,10461
2024-09-08,机场,入境,34293,7572,13896,55761
2024-09-08,机场,出境,26188,8869,17733,52790
2024-09-08,高铁西九龙,入境,24929,12351,1064,38344
2024-09-08,高铁西九龙,出境,12432,15645,1431,29508
2024-09-08,罗湖,入境,109542,13095,610,123247
2024-09-08,罗湖,出境,74205,15174,713,90092
2024-09-08,落马洲支线,入境,86169,16769,415,103353
2024-09-08,落马洲支线,出境,63516,15915,393,79824
2024-09-08,香园围,入境,43610,9507,106,53223
2024-09-08,香园围,出境,33016,6275,309,39600
2024-09-08,港珠澳大桥,入境,40818,5063,4532,50413
2024-09-08,港珠澳大桥,出境,23261,6583,4876,34720
2024-09-08,落马洲,入境,24264,2349,340,26953
2024-09-08,落马洲,出境,12151,3011,498,15660
2024-09-08,文锦渡,入境,1935,480,7,2422
2024-09-08,文锦渡,出境,1119,421,6,1546
2024-09-08,沙头角,入境,0,0,0,0
2024-09-08,沙头角,出境,0,0,0,0
2024-09-08,深圳湾,入境,57020,12594,812,70426
2024-09-08,深圳湾,出境,35540,13491,1174,50205
2024-09-08,中国客运码头,入境,598,315,26,939
2024-09-08,中国客运码头,出境,260,286,34,580
2024-09-08,港口管制,入境,33,0,48,81
2024-09-08,港口管制,出境,0,0,16,16
2024-09-08,启德邮轮码头,入境,0,0,0,0
2024-09-08,启德邮轮码头,出境,0,0,0,0
2024-09-08,港澳客轮码头,入境,8145,655,1688,10488
2024-09-08,港澳客轮码头,出境,5228,813,2415,8456
2024-09-09,机场,入境,29897,8237,13911,52045
2024-09-09,机场,出境,24632,6645,12666,43943
2024-09-09,高铁西九龙,入境,15275,11617,1146,28038
2024-09-09,高铁西九龙,出境,12729,9671,1366,23766
2024-09-09,罗湖,入境,70717,12252,587,83556
2024-09-09,罗湖,出境,66706,11907,731,79344
2024-09-09,落马洲支线,入境,54943,12321,323,67587
2024-09-09,落马洲支线,出境,54483,11248,372,66103
2024-09-09,香园围,入境,28168,7165,143,35476
2024-09-09,香园围,出境,27678,2948,128,30754
2024-09-09,港珠澳大桥,入境,21060,3876,3030,27966
2024-09-09,港珠澳大桥,出境,18037,6211,2688,26936
2024-09-09,落马洲,入境,12271,2751,252,15274
2024-09-09,落马洲,出境,8739,2681,489,11909
2024-09-09,文锦渡,入境,2143,495,7,2645
2024-09-09,文锦渡,出境,2103,407,6,2516
2024-09-09,沙头角,入境,0,0,0,0
2024-09-09,沙头角,出境,0,0,0,0
2024-09-09,深圳湾,入境,30565,9781,670,41016
2024-09-09,深圳湾,出境,28431,8469,1267,38167
2024-09-09,中国客运码头,入境,389,341,40,770
2024-09-09,中国客运码头,出境,489,233,55,777
2024-09-09,港口管制,入境,1,0,64,65
2024-09-09,港口管制,出境,0,0,59,59
2024-09-09,启德邮轮码头,入境,0,0,0,0
2024-09-09,启德邮轮码头,出境,0,0,0,0
2024-09-09,港澳客轮码头,入境,5872,656,1605,8133
2024-09-09,港澳客轮码头,出境,4700,912,2140,7752
2024-09-10,机场,入境,25029,7631,12745,45405
2024-09-10,机场,出境,21226,5645,12084,38955
2024-09-10,高铁西九龙,入境,12747,12280,1007,26034
2024-09-10,高铁西九龙,出境,12386,9931,1139,23456
2024-09-10,罗湖,入境,65686,11582,578,77846
2024-09-10,罗湖,出境,66198,12623,629,79450
2024-09-10,落马洲支线,入境,51054,13085,329,64468
2024-09-10,落马洲支线,出境,52971,12025,351,65347
2024-09-10,香园围,入境,27425,6846,112,34383
2024-09-10,香园围,出境,27180,3705,233,31118
2024-09-10,港珠澳大桥,入境,17896,3641,3535,25072
2024-09-10,港珠澳大桥,出境,18396,7993,3353,29742
2024-09-10,落马洲,入境,9980,2219,292,12491
2024-09-10,落马洲,出境,8972,2531,497,12000
2024-09-10,文锦渡,入境,1979,410,25,2414
2024-09-10,文锦渡,出境,1997,365,9,2371
2024-09-10,沙头角,入境,0,0,0,0
2024-09-10,沙头角,出境,0,0,0,0
2024-09-10,深圳湾,入境,27824,9321,790,37935
2024-09-10,深圳湾,出境,28129,8476,1160,37765
2024-09-10,中国客运码头,入境,325,357,34,716
2024-09-10,中国客运码头,出境,497,278,43,818
2024-09-10,港口管制,入境,2,2,48,52
2024-09-10,港口管制,出境,2,1,52,55
2024-09-10,启德邮轮码头,入境,0,0,0,0
2024-09-10,启德邮轮码头,出境,0,0,0,0
2024-09-10,港澳客轮码头,入境,4909,707,1858,7474
2024-09-10,港澳客轮码头,出境,4851,877,2243,7971
2024-09-11,机场,入境,23446,6604,13357,43407
2024-09-11,机场,出境,22287,6141,12047,40475
2024-09-11,高铁西九龙,入境,12586,11311,1178,25075
2024-09-11,高铁西九龙,出境,12474,10954,1082,24510
2024-09-11,罗湖,入境,66257,11314,576,78147
2024-09-11,罗湖,出境,66289,12953,600,79842
2024-09-11,落马洲支线,入境,51831,12286,298,64415
2024-09-11,落马洲支线,出境,53244,11826,317,65387
2024-09-11,香园围,入境,27151,6656,110,33917
2024-09-11,香园围,出境,27062,3149,141,30352
2024-09-11,港珠澳大桥,入境,17705,3672,3315,24692
2024-09-11,港珠澳大桥,出境,17753,7537,2940,28230
2024-09-11,落马洲,入境,10274,2127,315,12716
2024-09-11,落马洲,出境,8790,2677,382,11849
2024-09-11,文锦渡,入境,2013,477,12,2502
2024-09-11,文锦渡,出境,2184,450,9,2643
2024-09-11,沙头角,入境,0,0,0,0
2024-09-11,沙头角,出境,0,0,0,0
2024-09-11,深圳湾,入境,28096,9098,923,38117
2024-09-11,深圳湾,出境,27729,8909,922,37560
2024-09-11,中国客运码头,入境,423,358,45,826
2024-09-11,中国客运码头,出境,393,359,103,855
2024-09-11,港口管制,入境,0,0,38,38
2024-09-11,港口管制,出境,102,0,29,131
2024-09-11,启德邮轮码头,入境,7,1,2621,2629
2024-09-11,启德邮轮码头,出境,6,1,2640,2647
2024-09-11,港澳客轮码头,入境,4823,863,1641,7327
2024-09-11,港澳客轮码头,出境,4616,1137,1973,7726
2024-09-12,机场,入境,22109,6851,15390,44350
2024-09-12,机场,出境,26421,6702,13192,46315
2024-09-12,高铁西九龙,入境,12343,11616,1373,25332
2024-09-12,高铁西九龙,出境,13892,11403,1084,26379
2024-09-12,罗湖,入境,65859,10852,663,77374
2024-09-12,罗湖,出境,67397,12581,642,80620
2024-09-12,落马洲支线,入境,51649,12052,358,64059
2024-09-12,落马洲支线,出境,53491,12022,327,65840
2024-09-12,香园围,入境,27444,5377,201,33022
2024-09-12,香园围,出境,28251,3353,139,31743
2024-09-12,港珠澳大桥,入境,17690,3326,3031,24047
2024-09-12,港珠澳大桥,出境,18952,7527,2726,29205
2024-09-12,落马洲,入境,10214,2074,455,12743
2024-09-12,落马洲,出境,8894,2537,332,11763
2024-09-12,文锦渡,入境,2043,416,17,2476
2024-09-12,文锦渡,出境,2179,377,11,2567
2024-09-12,沙头角,入境,0,0,0,0
2024-09-12,沙头角,出境,0,0,0,0
2024-09-12,深圳湾,入境,28871,8776,1069,38716
2024-09-12,深圳湾,出境,29573,8702,778,39053
2024-09-12,中国客运码头,入境,430,344,41,815
2024-09-12,中国客运码头,出境,467,360,35,862
2024-09-12,港口管制,入境,1,3,39,43
2024-09-12,港口管制,出境,0,0,45,45
2024-09-12,启德邮轮码头,入境,0,0,0,0
2024-09-12,启德邮轮码头,出境,0,0,0,0
2024-09-12,港澳客轮码头,入境,4745,740,1873,7358
2024-09-12,港澳客轮码头,出境,4764,1078,2290,8132
2024-09-13,机场,入境,25500,8832,21062,55394
2024-09-13,机场,出境,35582,9215,14404,59201
2024-09-13,高铁西九龙,入境,13163,12655,1706,27524
2024-09-13,高铁西九龙,出境,24933,12318,1117,38368
2024-09-13,罗湖,入境,67433,11379,708,79520
2024-09-13,罗湖,出境,85310,13744,698,99752
2024-09-13,落马洲支线,入境,52201,12425,506,65132
2024-09-13,落马洲支线,出境,67226,13704,410,81340
2024-09-13,香园围,入境,27974,4352,204,32530
2024-09-13,香园围,出境,32735,3239,423,36397
2024-09-13,港珠澳大桥,入境,19123,3647,3600,26370
2024-09-13,港珠澳大桥,出境,30550,5874,3137,39561
2024-09-13,落马洲,入境,10812,2849,701,14362
2024-09-13,落马洲,出境,11543,2709,329,14581
2024-09-13,文锦渡,入境,1922,455,13,2390
2024-09-13,文锦渡,出境,2296,351,13,2660
2024-09-13,沙头角,入境,0,0,0,0
2024-09-13,沙头角,出境,0,0,0,0
2024-09-13,深圳湾,入境,29498,9977,1644,41119
2024-09-13,深圳湾,出境,42204,10645,789,53638
2024-09-13,中国客运码头,入境,431,413,56,900
2024-09-13,中国客运码头,出境,822,350,41,1213
2024-09-13,港口管制,入境,0,0,57,57
2024-09-13,港口管制,出境,1,1,39,41
2024-09-13,启德邮轮码头,入境,0,0,0,0
2024-09-13,启德邮轮码头,出境,0,0,0,0
2024-09-13,港澳客轮码头,入境,5331,787,2379,8497
2024-09-13,港澳客轮码头,出境,7152,990,2396,10538
2024-09-14,机场,入境,24846,10498,25903,61247
2024-09-14,机场,出境,34749,10268,14340,59357
2024-09-14,高铁西九龙,入境,14375,16701,1716,32792
2024-09-14,高铁西九龙,出境,25749,10922,1269,37940
2024-09-14,罗湖,入境,80340,12240,748,93328
2024-09-14,罗湖,出境,113620,13323,742,127685
2024-09-14,落马洲支线,入境,63208,13531,518,77257
2024-09-14,落马洲支线,出境,88961,11854,464,101279
2024-09-14,香园围,入境,32504,4812,187,37503
2024-09-14,香园围,出境,41937,3010,344,45291
2024-09-14,港珠澳大桥,入境,23782,4035,5759,33576
2024-09-14,港珠澳大桥,出境,41774,5464,4843,52081
2024-09-14,落马洲,入境,16579,3241,679,20499
2024-09-14,落马洲,出境,16939,3234,477,20650
2024-09-14,文锦渡,入境,1519,412,11,1942
2024-09-14,文锦渡,出境,2131,308,12,2451
2024-09-14,沙头角,入境,0,0,0,0
2024-09-14,沙头角,出境,0,0,0,0
2024-09-14,深圳湾,入境,36595,11656,1508,49759
2024-09-14,深圳湾,出境,53188,9085,888,63161
2024-09-14,中国客运码头,入境,490,400,65,955
2024-09-14,中国客运码头,出境,1134,294,18,1446
2024-09-14,港口管制,入境,69,1,22,92
2024-09-14,港口管制,出境,0,0,23,23
2024-09-14,启德邮轮码头,入境,0,0,0,0
2024-09-14,启德邮轮码头,出境,0,0,0,0
2024-09-14,港澳客轮码头,入境,6188,1028,3321,10537
2024-09-14,港澳客轮码头,出境,8355,925,3329,12609
2024-09-15,机场,入境,31997,10244,20639,62880
2024-09-15,机场,出境,24364,10972,17304,52640
2024-09-15,高铁西九龙,入境,28163,35113,1731,65007
2024-09-15,高铁西九龙,出境,14149,19899,1364,35412
2024-09-15,罗湖,入境,110246,22421,929,133596
2024-09-15,罗湖,出境,74936,23356,912,99204
2024-09-15,落马洲支线,入境,85815,29266,568,115649
2024-09-15,落马洲支线,出境,61799,23066,501,85366
2024-09-15,香园围,入境,43255,9127,176,52558
2024-09-15,香园围,出境,32424,5377,290,38091
2024-09-15,港珠澳大桥,入境,46422,6706,5383,58511
2024-09-15,港珠澳大桥,出境,23619,7376,5672,36667
2024-09-15,落马洲,入境,24661,4812,482,29955
2024-09-15,落马洲,出境,12120,4358,453,16931
2024-09-15,文锦渡,入境,1891,678,11,2580
2024-09-15,文锦渡,出境,1220,455,11,1686
2024-09-15,沙头角,入境,0,0,0,0
2024-09-15,沙头角,出境,0,0,0,0
2024-09-15,深圳湾,入境,61051,20449,1214,82714
2024-09-15,深圳湾,出境,36601,14108,955,51664
2024-09-15,中国客运码头,入境,1296,899,76,2271
2024-09-15,中国客运码头,出境,542,481,36,1059
2024-09-15,港口管制,入境,1,0,35,36
2024-09-15,港口管制,出境,0,0,24,24
2024-09-15,启德邮轮码头,入境,0,0,0,0
2024-09-15,启德邮轮码头,出境,0,0,0,0
2024-09-15,港澳客轮码头,入境,8962,1559,3687,14208
2024-09-15,港澳客轮码头,出境,5145,1643,4525,11313
2024-09-16,机场,入境,26279,6394,17209,49882
2024-09-16,机场,出境,20066,7311,19630,47007
2024-09-16,高铁西九龙,入境,13856,30236,1435,45527
2024-09-16,高铁西九龙,出境,12711,24150,1311,38172
2024-09-16,罗湖,入境,64368,24983,921,90272
2024-09-16,罗湖,出境,63506,35420,986,99912
2024-09-16,落马洲支线,入境,51595,36634,599,88828
2024-09-16,落马洲支线,出境,49899,34547,583,85029
2024-09-16,香园围,入境,26934,8937,195,36066
2024-09-16,香园围,出境,26728,6335,198,33261
2024-09-16,港珠澳大桥,入境,20522,6741,4755,32018
2024-09-16,港珠澳大桥,出境,18076,9389,3251,30716
2024-09-16,落马洲,入境,11854,4034,327,16215
2024-09-16,落马洲,出境,8618,5772,427,14817
2024-09-16,文锦渡,入境,2027,837,14,2878
2024-09-16,文锦渡,出境,2093,578,21,2692
2024-09-16,沙头角,入境,0,0,0,0
2024-09-16,沙头角,出境,0,0,0,0
2024-09-16,深圳湾,入境,29955,18872,967,49794
2024-09-16,深圳湾,出境,29210,19504,1148,49862
2024-09-16,中国客运码头,入境,584,830,53,1467
2024-09-16,中国客运码头,出境,617,656,65,1338
2024-09-16,港口管制,入境,0,0,5,5
2024-09-16,港口管制,出境,1,0,33,34
2024-09-16,启德邮轮码头,入境,0,0,0,0
2024-09-16,启德邮轮码头,出境,0,0,0,0
2024-09-16,港澳客轮码头,入境,5627,1872,3373,10872
2024-09-16,港澳客轮码头,出境,4123,2193,4409,10725
2024-09-17,机场,入境,21509,11206,16295,49010
2024-09-17,机场,出境,25216,10224,20612,56052
2024-09-17,高铁西九龙,入境,8458,13061,1099,22618
2024-09-17,高铁西九龙,出境,19891,23882,1644,45417
2024-09-17,罗湖,入境,46305,10940,667,57912
2024-09-17,罗湖,出境,75743,18708,821,95272
2024-09-17,落马洲支线,入境,36658,13483,344,50485
2024-09-17,落马洲支线,出境,60915,18140,511,79566
2024-09-17,香园围,入境,18095,3912,85,22092
2024-09-17,香园围,出境,25693,3971,180,29844
2024-09-17,港珠澳大桥,入境,13462,3353,3729,20544
2024-09-17,港珠澳大桥,出境,28486,5957,2732,37175
2024-09-17,落马洲,入境,8629,1913,297,10839
2024-09-17,落马洲,出境,12786,4656,624,18066
2024-09-17,文锦渡,入境,1792,362,8,2162
2024-09-17,文锦渡,出境,2546,359,12,2917
2024-09-17,沙头角,入境,0,0,0,0
2024-09-17,沙头角,出境,0,0,0,0
2024-09-17,深圳湾,入境,20529,8870,780,30179
2024-09-17,深圳湾,出境,35772,15430,1696,52898
2024-09-17,中国客运码头,入境,288,287,21,596
2024-09-17,中国客运码头,出境,917,530,62,1509
2024-09-17,港口管制,入境,0,0,80,80
2024-09-17,港口管制,出境,0,0,75,75
2024-09-17,启德邮轮码头,入境,0,0,0,0
2024-09-17,启德邮轮码头,出境,0,0,0,0
2024-09-17,港澳客轮码头,入境,3442,1057,2523,7022
2024-09-17,港澳客轮码头,出境,7518,1236,3279,12033
2024-09-18,机场,入境,30334,10212,16163,56709
2024-09-18,机场,出境,35924,7005,15074,58003
2024-09-18,高铁西九龙,入境,26295,9674,1182,37151
2024-09-18,高铁西九龙,出境,16446,8548,1263,26257
2024-09-18,罗湖,入境,104036,10022,605,114663
2024-09-18,罗湖,出境,71339,10008,696,82043
2024-09-18,落马洲支线,入境,78612,8782,322,87716
2024-09-18,落马洲支线,出境,62860,8646,374,71880
2024-09-18,香园围,入境,39781,4618,216,44615
2024-09-18,香园围,出境,31689,2294,186,34169
2024-09-18,港珠澳大桥,入境,38247,3688,5159,47094
2024-09-18,港珠澳大桥,出境,25055,4607,4536,34198
2024-09-18,落马洲,入境,19658,1933,306,21897
2024-09-18,落马洲,出境,13284,3564,576,17424
2024-09-18,文锦渡,入境,1794,282,14,2090
2024-09-18,文锦渡,出境,1088,214,12,1314
2024-09-18,沙头角,入境,0,0,0,0
2024-09-18,沙头角,出境,0,0,0,0
2024-09-18,深圳湾,入境,53567,7957,767,62291
2024-09-18,深圳湾,出境,36161,7151,1327,44639
2024-09-18,中国客运码头,入境,1185,318,38,1541
2024-09-18,中国客运码头,出境,517,271,48,836
2024-09-18,港口管制,入境,0,9,64,73
2024-09-18,港口管制,出境,0,0,25,25
2024-09-18,启德邮轮码头,入境,0,0,0,0
2024-09-18,启德邮轮码头,出境,0,0,0,0
2024-09-18,港澳客轮码头,入境,8130,694,2155,10979
2024-09-18,港澳客轮码头,出境,5360,846,2745,8951
2024-09-19,机场,入境,21243,7628,15008,43879
2024-09-19,机场,出境,28907,6263,14563,49733
2024-09-19,高铁西九龙,入境,16463,13180,1281,30924
2024-09-19,高铁西九龙,出境,13263,10526,1207,24996
2024-09-19,罗湖,入境,69875,12285,745,82905
2024-09-19,罗湖,出境,62624,12641,832,76097
2024-09-19,落马洲支线,入境,53427,11811,379,65617
2024-09-19,落马洲支线,出境,52507,11307,424,64238
2024-09-19,香园围,入境,27419,6284,187,33890
2024-09-19,香园围,出境,27195,2497,227,29919
2024-09-19,港珠澳大桥,入境,20476,3976,3446,27898
2024-09-19,港珠澳大桥,出境,19051,6163,2922,28136
2024-09-19,落马洲,入境,11860,2735,302,14897
2024-09-19,落马洲,出境,8538,2689,407,11634
2024-09-19,文锦渡,入境,2077,379,12,2468
2024-09-19,文锦渡,出境,2022,305,4,2331
2024-09-19,沙头角,入境,0,0,0,0
2024-09-19,沙头角,出境,0,0,0,0
2024-09-19,深圳湾,入境,30300,10120,834,41254
2024-09-19,深圳湾,出境,28225,8518,942,37685
2024-09-19,中国客运码头,入境,562,338,110,1010
2024-09-19,中国客运码头,出境,484,317,49,850
2024-09-19,港口管制,入境,23,0,40,63
2024-09-19,港口管制,出境,23,9,116,148
2024-09-19,启德邮轮码头,入境,0,0,0,0
2024-09-19,启德邮轮码头,出境,0,0,0,0
2024-09-19,港澳客轮码头,入境,5517,752,2081,8350
2024-09-19,港澳客轮码头,出境,5020,1060,2458,8538
2024-09-20,机场,入境,20528,7732,16374,44634
2024-09-20,机场,出境,33900,7171,15558,56629
2024-09-20,高铁西九龙,入境,13413,13273,1446,28132
2024-09-20,高铁西九龙,出境,21674,11824,1332,34830
2024-09-20,罗湖,入境,64473,11637,791,76901
2024-09-20,罗湖,出境,75711,13478,858,90047
2024-09-20,落马洲支线,入境,51137,12250,410,63797
2024-09-20,落马洲支线,出境,63701,12117,370,76188
2024-09-20,香园围,入境,26840,7360,105,34305
2024-09-20,香园围,出境,31001,3308,327,34636
2024-09-20,港珠澳大桥,入境,18914,4061,3735,26710
2024-09-20,港珠澳大桥,出境,26882,7571,3045,37498
2024-09-20,落马洲,入境,10164,2434,387,12985
2024-09-20,落马洲,出境,10822,2787,360,13969
2024-09-20,文锦渡,入境,1946,421,11,2378
2024-09-20,文锦渡,出境,2272,386,14,2672
2024-09-20,沙头角,入境,0,0,0,0
2024-09-20,沙头角,出境,0,0,0,0
2024-09-20,深圳湾,入境,28736,9680,1031,39447
2024-09-20,深圳湾,出境,36646,9531,894,47071
2024-09-20,中国客运码头,入境,485,367,41,893
2024-09-20,中国客运码头,出境,659,327,31,1017
2024-09-20,港口管制,入境,22,0,38,60
2024-09-20,港口管制,出境,28,0,25,53
2024-09-20,启德邮轮码头,入境,0,0,0,0
2024-09-20,启德邮轮码头,出境,0,0,0,0
2024-09-20,港澳客轮码头,入境,5468,855,2462,8785
2024-09-20,港澳客轮码头,出境,6467,1028,2660,10155
2024-09-21,机场,入境,26252,8533,17296,52081
2024-09-21,机场,出境,29469,7071,18594,55134
2024-09-21,高铁西九龙,入境,14295,21447,1407,37149
2024-09-21,高铁西九龙,出境,22204,17256,1364,40824
2024-09-21,罗湖,入境,72173,14715,756,87644
2024-09-21,罗湖,出境,97298,16560,824,114682
2024-09-21,落马洲支线,入境,57525,17738,412,75675
2024-09-21,落马洲支线,出境,82168,16856,406,99430
2024-09-21,香园围,入境,29582,11395,188,41165
2024-09-21,香园围,出境,37459,5117,265,42841
2024-09-21,港珠澳大桥,入境,22237,4972,4786,31995
2024-09-21,港珠澳大桥,出境,37777,9268,3975,51020
2024-09-21,落马洲,入境,14369,2505,351,17225
2024-09-21,落马洲,出境,14931,3269,325,18525
2024-09-21,文锦渡,入境,1271,469,13,1753
2024-09-21,文锦渡,出境,1846,397,16,2259
2024-09-21,沙头角,入境,0,0,0,0
2024-09-21,沙头角,出境,0,0,0,0
2024-09-21,深圳湾,入境,31908,13197,1033,46138
2024-09-21,深圳湾,出境,46246,11844,972,59062
2024-09-21,中国客运码头,入境,373,678,119,1170
2024-09-21,中国客运码头,出境,707,520,31,1258
2024-09-21,港口管制,入境,2,3,29,34
2024-09-21,港口管制,出境,0,0,32,32
2024-09-21,启德邮轮码头,入境,0,0,0,0
2024-09-21,启德邮轮码头,出境,0,0,0,0
2024-09-21,港澳客轮码头,入境,5562,848,2659,9069
2024-09-21,港澳客轮码头,出境,8282,944,2742,11968
2024-09-22,机场,入境,41192,8209,15217,64618
2024-09-22,机场,出境,26717,9800,23496,60013
2024-09-22,高铁西九龙,入境,27255,13390,1138,41783
2024-09-22,高铁西九龙,出境,12356,17348,1548,31252
2024-09-22,罗湖,入境,103076,12439,720,116235
2024-09-22,罗湖,出境,67405,15356,747,83508
2024-09-22,落马洲支线,入境,82231,15849,420,98500
2024-09-22,落马洲支线,出境,58430,15700,488,74618
2024-09-22,香园围,入境,41844,12827,272,54943
2024-09-22,香园围,出境,31025,5100,181,36306
2024-09-22,港珠澳大桥,入境,43147,5647,4442,53236
2024-09-22,港珠澳大桥,出境,21766,11112,4794,37672
2024-09-22,落马洲,入境,22244,2264,322,24830
2024-09-22,落马洲,出境,11222,4666,569,16457
2024-09-22,文锦渡,入境,1687,398,16,2101
2024-09-22,文锦渡,出境,1003,315,29,1347
2024-09-22,沙头角,入境,0,0,0,0
2024-09-22,沙头角,出境,0,0,0,0
2024-09-22,深圳湾,入境,56569,10833,923,68325
2024-09-22,深圳湾,出境,32928,12939,1180,47047
2024-09-22,中国客运码头,入境,960,355,34,1349
2024-09-22,中国客运码头,出境,344,364,54,762
2024-09-22,港口管制,入境,4,21,44,69
2024-09-22,港口管制,出境,0,4,30,34
2024-09-22,启德邮轮码头,入境,0,0,0,0
2024-09-22,启德邮轮码头,出境,0,0,0,0
2024-09-22,港澳客轮码头,入境,8686,879,2331,11896
2024-09-22,港澳客轮码头,出境,4637,980,3452,9069
2024-09-23,机场,入境,35417,8844,14988,59249
2024-09-23,机场,出境,26800,7888,19480,54168
2024-09-23,高铁西九龙,入境,16285,11917,1213,29415
2024-09-23,高铁西九龙,出境,12701,9981,1372,24054
2024-09-23,罗湖,入境,68970,10540,723,80233
2024-09-23,罗湖,出境,63566,10846,734,75146
2024-09-23,落马洲支线,入境,53886,11217,354,65457
2024-09-23,落马洲支线,出境,52273,10347,426,63046
2024-09-23,香园围,入境,26745,10121,211,37077
2024-09-23,香园围,出境,25713,3043,172,28928
2024-09-23,港珠澳大桥,入境,21032,4106,3309,28447
2024-09-23,港珠澳大桥,出境,17715,11199,2798,31712
2024-09-23,落马洲,入境,11888,2702,292,14882
2024-09-23,落马洲,出境,8577,2650,557,11784
2024-09-23,文锦渡,入境,2044,343,7,2394
2024-09-23,文锦渡,出境,1977,292,6,2275
2024-09-23,沙头角,入境,0,0,0,0
2024-09-23,沙头角,出境,0,0,0,0
2024-09-23,深圳湾,入境,30628,8739,927,40294
2024-09-23,深圳湾,出境,27483,8083,1301,36867
2024-09-23,中国客运码头,入境,442,330,49,821
2024-09-23,中国客运码头,出境,485,256,42,783
2024-09-23,港口管制,入境,2,0,45,47
2024-09-23,港口管制,出境,0,0,74,74
2024-09-23,启德邮轮码头,入境,0,0,0,0
2024-09-23,启德邮轮码头,出境,0,0,0,0
2024-09-23,港澳客轮码头,入境,5407,647,1849,7903
2024-09-23,港澳客轮码头,出境,4557,935,2360,7852
2024-09-24,机场,入境,27443,7061,13130,47634
2024-09-24,机场,出境,23589,6736,15512,45837
2024-09-24,高铁西九龙,入境,12960,11363,1263,25586
2024-09-24,高铁西九龙,出境,12243,9529,1157,22929
2024-09-24,罗湖,入境,60830,9226,655,70711
2024-09-24,罗湖,出境,60105,9886,641,70632
2024-09-24,落马洲支线,入境,48382,10639,346,59367
2024-09-24,落马洲支线,出境,49987,9548,362,59897
2024-09-24,香园围,入境,23774,10440,134,34348
2024-09-24,香园围,出境,23821,3573,194,27588
2024-09-24,港珠澳大桥,入境,16755,3814,3040,23609
2024-09-24,港珠澳大桥,出境,16502,10484,2712,29698
2024-09-24,落马洲,入境,9601,2099,437,12137
2024-09-24,落马洲,出境,8414,2519,380,11313
2024-09-24,文锦渡,入境,1940,356,15,2311
2024-09-24,文锦渡,出境,1968,320,19,2307
2024-09-24,沙头角,入境,0,0,0,0
2024-09-24,沙头角,出境,0,0,0,0
2024-09-24,深圳湾,入境,26647,8416,992,36055
2024-09-24,深圳湾,出境,25502,7262,1096,33860
2024-09-24,中国客运码头,入境,336,351,31,718
2024-09-24,中国客运码头,出境,419,243,38,700
2024-09-24,港口管制,入境,41,0,42,83
2024-09-24,港口管制,出境,6,1,54,61
2024-09-24,启德邮轮码头,入境,22,4,893,919
2024-09-24,启德邮轮码头,出境,616,2100,656,3372
2024-09-24,港澳客轮码头,入境,4497,719,2049,7265
2024-09-24,港澳客轮码头,出境,4158,919,2103,7180
2024-09-25,机场,入境,24419,6852,12955,44226
2024-09-25,机场,出境,26401,8036,14642,49079
2024-09-25,高铁西九龙,入境,13049,11660,1375,26084
2024-09-25,高铁西九龙,出境,13404,10747,1026,25177
2024-09-25,罗湖,入境,63670,10270,772,74712
2024-09-25,罗湖,出境,63527,11558,719,75804
2024-09-25,落马洲支线,入境,50848,11638,438,62924
2024-09-25,落马洲支线,出境,52802,11156,345,64303
2024-09-25,香园围,入境,26161,9830,201,36192
2024-09-25,香园围,出境,26287,3210,235,29732
2024-09-25,港珠澳大桥,入境,17278,4070,3227,24575
2024-09-25,港珠澳大桥,出境,17401,9859,2713,29973
2024-09-25,落马洲,入境,10170,2242,491,12903
2024-09-25,落马洲,出境,8480,2644,400,11524
2024-09-25,文锦渡,入境,2000,353,30,2383
2024-09-25,文锦渡,出境,2026,313,10,2349
2024-09-25,沙头角,入境,0,0,0,0
2024-09-25,沙头角,出境,0,0,0,0
2024-09-25,深圳湾,入境,28502,9271,1120,38893
2024-09-25,深圳湾,出境,27559,8117,817,36493
2024-09-25,中国客运码头,入境,410,370,34,814
2024-09-25,中国客运码头,出境,449,307,49,805
2024-09-25,港口管制,入境,0,0,35,35
2024-09-25,港口管制,出境,2,17,30,49
2024-09-25,启德邮轮码头,入境,0,0,0,0
2024-09-25,启德邮轮码头,出境,0,0,0,0
2024-09-25,港澳客轮码头,入境,4355,764,1840,6959
2024-09-25,港澳客轮码头,出境,4234,1067,2184,7485
2024-09-26,机场,入境,23127,7416,13542,44085
2024-09-26,机场,出境,31206,10466,15241,56913
2024-09-26,高铁西九龙,入境,13486,12366,1656,27508
2024-09-26,高铁西九龙,出境,13886,11518,959,26363
2024-09-26,罗湖,入境,66382,10446,723,77551
2024-09-26,罗湖,出境,65900,11988,655,78543
2024-09-26,落马洲支线,入境,52491,11789,428,64708
2024-09-26,落马洲支线,出境,54341,11897,321,66559
2024-09-26,香园围,入境,28279,6373,193,34845
2024-09-26,香园围,出境,29114,3982,231,33327
2024-09-26,港珠澳大桥,入境,18000,3743,3049,24792
2024-09-26,港珠澳大桥,出境,19660,10752,2831,33243
2024-09-26,落马洲,入境,10323,2811,614,13748
2024-09-26,落马洲,出境,8965,2686,325,11976
2024-09-26,文锦渡,入境,2051,420,12,2483
2024-09-26,文锦渡,出境,2092,346,8,2446
2024-09-26,沙头角,入境,0,0,0,0
2024-09-26,沙头角,出境,0,0,0,0
2024-09-26,深圳湾,入境,29252,10764,1352,41368
2024-09-26,深圳湾,出境,29017,8928,836,38781
2024-09-26,中国客运码头,入境,439,363,76,878
2024-09-26,中国客运码头,出境,415,300,42,757
2024-09-26,港口管制,入境,0,0,37,37
2024-09-26,港口管制,出境,43,0,30,73
2024-09-26,启德邮轮码头,入境,0,0,0,0
2024-09-26,启德邮轮码头,出境,0,0,0,0
2024-09-26,港澳客轮码头,入境,4760,732,1911,7403
2024-09-26,港澳客轮码头,出境,5053,1213,2091,8357
2024-09-27,机场,入境,27202,8302,15031,50535
2024-09-27,机场,出境,39710,14256,14877,68843
2024-09-27,高铁西九龙,入境,14279,13190,1785,29254
2024-09-27,高铁西九龙,出境,23699,11992,914,36605
2024-09-27,罗湖,入境,67471,11082,812,79365
2024-09-27,罗湖,出境,81183,12965,752,94900
2024-09-27,落马洲支线,入境,54074,13062,460,67596
2024-09-27,落马洲支线,出境,68461,12938,333,81732
2024-09-27,香园围,入境,28591,5163,269,34023
2024-09-27,香园围,出境,33014,3751,291,37056
2024-09-27,港珠澳大桥,入境,19554,3790,3710,27054
2024-09-27,港珠澳大桥,出境,29662,6867,2873,39402
2024-09-27,落马洲,入境,11058,3735,809,15602
2024-09-27,落马洲,出境,11923,2801,264,14988
2024-09-27,文锦渡,入境,2068,472,12,2552
2024-09-27,文锦渡,出境,2433,404,6,2843
2024-09-27,沙头角,入境,0,0,0,0
2024-09-27,沙头角,出境,0,0,0,0
2024-09-27,深圳湾,入境,31530,12982,2010,46522
2024-09-27,深圳湾,出境,40340,9844,813,50997
2024-09-27,中国客运码头,入境,491,377,74,942
2024-09-27,中国客运码头,出境,858,390,51,1299
2024-09-27,港口管制,入境,4,0,53,57
2024-09-27,港口管制,出境,4,0,25,29
2024-09-27,启德邮轮码头,入境,0,0,0,0
2024-09-27,启德邮轮码头,出境,0,0,0,0
2024-09-27,港澳客轮码头,入境,5689,774,2299,8762
2024-09-27,港澳客轮码头,出境,6884,1016,2421,10321
2024-09-28,机场,入境,27764,9390,14535,51689
2024-09-28,机场,出境,35467,18977,16180,70624
2024-09-28,高铁西九龙,入境,14418,18974,1844,35236
2024-09-28,高铁西九龙,出境,26444,13649,1008,41101
2024-09-28,罗湖,入境,78175,13048,812,92035
2024-09-28,罗湖,出境,109898,15501,711,126110
2024-09-28,落马洲支线,入境,64339,18407,567,83313
2024-09-28,落马洲支线,出境,93930,17285,366,111581
2024-09-28,香园围,入境,31837,8039,261,40137
2024-09-28,香园围,出境,42443,5719,194,48356
2024-09-28,港珠澳大桥,入境,22590,5056,5860,33506
2024-09-28,港珠澳大桥,出境,43612,6398,4410,54420
2024-09-28,落马洲,入境,16650,5285,873,22808
2024-09-28,落马洲,出境,17554,3816,226,21596
2024-09-28,文锦渡,入境,1470,985,35,2490
2024-09-28,文锦渡,出境,2154,650,7,2811
2024-09-28,沙头角,入境,0,0,0,0
2024-09-28,沙头角,出境,0,0,0,0
2024-09-28,深圳湾,入境,36942,18473,2227,57642
2024-09-28,深圳湾,出境,54433,12612,786,67831
2024-09-28,中国客运码头,入境,346,489,69,904
2024-09-28,中国客运码头,出境,979,376,30,1385
2024-09-28,港口管制,入境,0,0,62,62
2024-09-28,港口管制,出境,0,0,30,30
2024-09-28,启德邮轮码头,入境,615,2095,609,3319
2024-09-28,启德邮轮码头,出境,293,3126,85,3504
2024-09-28,港澳客轮码头,入境,5771,836,2686,9293
2024-09-28,港澳客轮码头,出境,8887,831,2881,12599
2024-09-29,机场,入境,33753,8340,10761,52854
2024-09-29,机场,出境,23518,18059,21104,62681
2024-09-29,高铁西九龙,入境,25036,15378,1536,41950
2024-09-29,高铁西九龙,出境,14304,10582,847,25733
2024-09-29,罗湖,入境,109259,11227,781,121267
2024-09-29,罗湖,出境,79336,11127,580,91043
2024-09-29,落马洲支线,入境,88509,13376,481,102366
2024-09-29,落马洲支线,出境,67051,10983,284,78318
2024-09-29,香园围,入境,44976,4872,176,50024
2024-09-29,香园围,出境,36557,3222,200,39979
2024-09-29,港珠澳大桥,入境,45179,4731,4961,54871
2024-09-29,港珠澳大桥,出境,27515,5564,4729,37808
2024-09-29,落马洲,入境,25670,4852,765,31287
2024-09-29,落马洲,出境,13250,2380,216,15846
2024-09-29,文锦渡,入境,1860,439,18,2317
2024-09-29,文锦渡,出境,1153,348,11,1512
2024-09-29,沙头角,入境,0,0,0,0
2024-09-29,沙头角,出境,0,0,0,0
2024-09-29,深圳湾,入境,62070,13869,1868,77807
2024-09-29,深圳湾,出境,38960,8031,591,47582
2024-09-29,中国客运码头,入境,913,416,50,1379
2024-09-29,中国客运码头,出境,496,372,20,888
2024-09-29,港口管制,入境,0,0,13,13
2024-09-29,港口管制,出境,0,1,37,38
2024-09-29,启德邮轮码头,入境,0,0,0,0
2024-09-29,启德邮轮码头,出境,0,0,0,0
2024-09-29,港澳客轮码头,入境,9426,983,2084,12493
2024-09-29,港澳客轮码头,出境,6637,1076,2687,10400
2024-09-30,机场,入境,33208,11626,10106,54940
2024-09-30,机场,出境,17708,26969,15301,59978
2024-09-30,高铁西九龙,入境,17202,26777,1660,45639
2024-09-30,高铁西九龙,出境,13455,11553,835,25843
2024-09-30,罗湖,入境,71845,16327,809,88981
2024-09-30,罗湖,出境,78689,13170,577,92436
2024-09-30,落马洲支线,入境,56948,18069,514,75531
2024-09-30,落马洲支线,出境,62342,12026,306,74674
2024-09-30,香园围,入境,28260,5665,241,34166
2024-09-30,香园围,出境,30182,3159,160,33501
2024-09-30,港珠澳大桥,入境,24969,6615,3734,35318
2024-09-30,港珠澳大桥,出境,24142,6225,3102,33469
2024-09-30,落马洲,入境,13853,8460,774,23087
2024-09-30,落马洲,出境,11950,2701,225,14876
2024-09-30,文锦渡,入境,2122,559,29,2710
2024-09-30,文锦渡,出境,2401,379,14,2794
2024-09-30,沙头角,入境,0,0,0,0
2024-09-30,沙头角,出境,0,0,0,0
2024-09-30,深圳湾,入境,33647,20193,1651,55491
2024-09-30,深圳湾,出境,29460,8138,592,38190
2024-09-30,中国客运码头,入境,724,663,48,1435
2024-09-30,中国客运码头,出境,614,472,30,1116
2024-09-30,港口管制,入境,0,2,34,36
2024-09-30,港口管制,出境,0,0,24,24
2024-09-30,启德邮轮码头,入境,0,0,0,0
2024-09-30,启德邮轮码头,出境,0,0,0,0
2024-09-30,港澳客轮码头,入境,6823,1484,2231,10538
2024-09-30,港澳客轮码头,出境,5903,1488,2332,9723
2024-10-01,机场,入境,40774,12140,10480,63394
2024-10-01,机场,出境,17694,31850,11989,61533
2024-10-01,高铁西九龙,入境,21069,48766,1261,71096
2024-10-01,高铁西九龙,出境,8991,17617,580,27188
2024-10-01,罗湖,入境,75389,38133,753,114275
2024-10-01,罗湖,出境,52097,38454,481,91032
2024-10-01,落马洲支线,入境,57987,46442,574,105003
2024-10-01,落马洲支线,出境,41770,21688,260,63718
2024-10-01,香园围,入境,26627,13365,192,40184
2024-10-01,香园围,出境,21017,4896,164,26077
2024-10-01,港珠澳大桥,入境,35151,11107,5437,51695
2024-10-01,港珠澳大桥,出境,22274,9999,4890,37163
2024-10-01,落马洲,入境,17639,12500,668,30807
2024-10-01,落马洲,出境,9527,4730,178,14435
2024-10-01,文锦渡,入境,1522,1255,27,2804
2024-10-01,文锦渡,出境,1085,438,5,1528
2024-10-01,沙头角,入境,0,0,0,0
2024-10-01,沙头角,出境,0,0,0,0
2024-10-01,深圳湾,入境,36991,33569,1469,72029
2024-10-01,深圳湾,出境,21974,11874,468,34316
2024-10-01,中国客运码头,入境,1168,2073,64,3305
2024-10-01,中国客运码头,出境,389,577,14,980
2024-10-01,港口管制,入境,36,0,32,68
2024-10-01,港口管制,出境,1,0,47,48
2024-10-01,启德邮轮码头,入境,0,0,0,0
2024-10-01,启德邮轮码头,出境,0,0,0,0
2024-10-01,港澳客轮码头,入境,6664,2294,1971,10929
2024-10-01,港澳客轮码头,出境,3488,2013,2067,7568
2024-10-02,机场,入境,28539,12995,12369,53903
2024-10-02,机场,出境,16324,22973,10782,50079
2024-10-02,高铁西九龙,入境,12951,41986,1164,56101
2024-10-02,高铁西九龙,出境,8447,25561,721,34729
2024-10-02,罗湖,入境,57575,36965,784,95324
2024-10-02,罗湖,出境,51251,45177,808,97236
2024-10-02,落马洲支线,入境,45397,46193,463,92053
2024-10-02,落马洲支线,出境,41387,37771,437,79595
2024-10-02,香园围,入境,20126,17388,270,37784
2024-10-02,香园围,出境,20557,10207,122,30886
2024-10-02,港珠澳大桥,入境,19500,12747,4416,36663
2024-10-02,港珠澳大桥,出境,17574,17565,4935,40074
2024-10-02,落马洲,入境,10240,9646,364,20250
2024-10-02,落马洲,出境,7675,7709,232,15616
2024-10-02,文锦渡,入境,2059,1361,19,3439
2024-10-02,文锦渡,出境,1954,753,11,2718
2024-10-02,沙头角,入境,0,0,0,0
2024-10-02,沙头角,出境,0,0,0,0
2024-10-02,深圳湾,入境,24553,31412,971,56936
2024-10-02,深圳湾,出境,20728,22044,614,43386
2024-10-02,中国客运码头,入境,602,1600,77,2279
2024-10-02,中国客运码头,出境,405,1448,47,1900
2024-10-02,港口管制,入境,0,0,52,52
2024-10-02,港口管制,出境,0,0,35,35
2024-10-02,启德邮轮码头,入境,293,3123,60,3476
2024-10-02,启德邮轮码头,出境,204,3231,85,3520
2024-10-02,港澳客轮码头,入境,3631,2666,2207,8504
2024-10-02,港澳客轮码头,出境,3273,3820,2554,9647
2024-10-03,机场,入境,19070,13309,15633,48012
2024-10-03,机场,出境,20389,16970,10887,48246
2024-10-03,高铁西九龙,入境,10313,39135,1049,50497
2024-10-03,高铁西九龙,出境,9997,28926,937,39860
2024-10-03,罗湖,入境,55320,34179,743,90242
2024-10-03,罗湖,出境,55962,45591,795,102348
2024-10-03,落马洲支线,入境,43709,42800,494,87003
2024-10-03,落马洲支线,出境,45620,39263,546,85429
2024-10-03,香园围,入境,22078,13604,109,35791
2024-10-03,香园围,出境,22928,7862,88,30878
2024-10-03,港珠澳大桥,入境,18436,13469,3053,34958
2024-10-03,港珠澳大桥,出境,19631,21941,2828,44400
2024-10-03,落马洲,入境,8954,6904,275,16133
2024-10-03,落马洲,出境,8137,7339,344,15820
2024-10-03,文锦渡,入境,2055,1224,12,3291
2024-10-03,文锦渡,出境,2049,710,9,2768
2024-10-03,沙头角,入境,0,0,0,0
2024-10-03,沙头角,出境,0,0,0,0
2024-10-03,深圳湾,入境,23236,26483,787,50506
2024-10-03,深圳湾,出境,23532,24799,1070,49401
2024-10-03,中国客运码头,入境,496,1830,112,2438
2024-10-03,中国客运码头,出境,567,1548,46,2161
2024-10-03,港口管制,入境,0,1,19,20
2024-10-03,港口管制,出境,0,0,15,15
2024-10-03,启德邮轮码头,入境,0,0,0,0
2024-10-03,启德邮轮码头,出境,0,0,0,0
2024-10-03,港澳客轮码头,入境,3400,3458,2080,8938
2024-10-03,港澳客轮码头,出境,3551,5279,2715,11545
2024-10-04,机场,入境,21908,18679,16381,56968
2024-10-04,机场,出境,30041,12616,11400,54057
2024-10-04,高铁西九龙,入境,9673,36736,1004,47413
2024-10-04,高铁西九龙,出境,15498,29722,1024,46244
2024-10-04,罗湖,入境,58297,31153,744,90194
2024-10-04,罗湖,出境,72074,45080,923,118077
2024-10-04,落马洲支线,入境,45449,37862,467,83778
2024-10-04,落马洲支线,出境,59747,38642,586,98975
2024-10-04,香园围,入境,24040,9929,136,34105
2024-10-04,香园围,出境,27673,7208,135,35016
2024-10-04,港珠澳大桥,入境,19323,13744,3375,36442
2024-10-04,港珠澳大桥,出境,27959,22577,3007,53543
2024-10-04,落马洲,入境,9497,5296,195,14988
2024-10-04,落马洲,出境,10633,9900,479,21012
2024-10-04,文锦渡,入境,1999,1093,13,3105
2024-10-04,文锦渡,出境,2320,703,8,3031
2024-10-04,沙头角,入境,0,0,0,0
2024-10-04,沙头角,出境,0,0,0,0
2024-10-04,深圳湾,入境,23751,24538,729,49018
2024-10-04,深圳湾,出境,33273,29389,1522,64184
2024-10-04,中国客运码头,入境,481,1672,89,2242
2024-10-04,中国客运码头,出境,813,1253,74,2140
2024-10-04,港口管制,入境,0,0,19,19
2024-10-04,港口管制,出境,5,0,26,31
2024-10-04,启德邮轮码头,入境,0,0,0,0
2024-10-04,启德邮轮码头,出境,0,0,0,0
2024-10-04,港澳客轮码头,入境,3799,3491,2630,9920
2024-10-04,港澳客轮码头,出境,4734,5348,3346,13428
2024-10-05,机场,入境,22485,24271,15485,62241
2024-10-05,机场,出境,32009,11986,12521,56516
2024-10-05,高铁西九龙,入境,11106,32880,841,44827
2024-10-05,高铁西九龙,出境,17910,36934,1207,56051
2024-10-05,罗湖,入境,72492,25218,596,98306
2024-10-05,罗湖,出境,94910,38542,933,134385
2024-10-05,落马洲支线,入境,57311,30600,415,88326
2024-10-05,落马洲支线,出境,82790,35834,617,119241
2024-10-05,香园围,入境,31025,8226,102,39353
2024-10-05,香园围,出境,37927,6893,179,44999
2024-10-05,港珠澳大桥,入境,25603,11124,5219,41946
2024-10-05,港珠澳大桥,出境,38751,16996,4696,60443
2024-10-05,落马洲,入境,14543,3658,197,18398
2024-10-05,落马洲,出境,16637,12005,684,29326
2024-10-05,文锦渡,入境,1499,886,11,2396
2024-10-05,文锦渡,出境,2032,712,15,2759
2024-10-05,沙头角,入境,0,0,0,0
2024-10-05,沙头角,出境,0,0,0,0
2024-10-05,深圳湾,入境,31638,19384,687,51709
2024-10-05,深圳湾,出境,44837,30811,1714,77362
2024-10-05,中国客运码头,入境,492,1402,78,1972
2024-10-05,中国客运码头,出境,767,1166,76,2009
2024-10-05,港口管制,入境,2,1,26,29
2024-10-05,港口管制,出境,0,0,10,10
2024-10-05,启德邮轮码头,入境,0,0,0,0
2024-10-05,启德邮轮码头,出境,0,0,0,0
2024-10-05,港澳客轮码头,入境,4592,2734,2584,9910
2024-10-05,港澳客轮码头,出境,6174,4102,3134,13410
2024-10-06,机场,入境,27725,30451,13624,71800
2024-10-06,机场,出境,26258,12398,16954,55610
2024-10-06,高铁西九龙,入境,20338,23466,738,44542
2024-10-06,高铁西九龙,出境,12359,38129,1489,51977
2024-10-06,罗湖,入境,99094,17691,661,117446
2024-10-06,罗湖,出境,68979,30684,928,100591
2024-10-06,落马洲支线,入境,75442,22072,393,97907
2024-10-06,落马洲支线,出境,57465,28876,655,86996
2024-10-06,香园围,入境,38408,7690,99,46197
2024-10-06,香园围,出境,30594,6450,180,37224
2024-10-06,港珠澳大桥,入境,44065,7875,4493,56433
2024-10-06,港珠澳大桥,出境,26997,11433,4677,43107
2024-10-06,落马洲,入境,22715,2516,200,25431
2024-10-06,落马洲,出境,12197,12254,826,25277
2024-10-06,文锦渡,入境,1846,740,7,2593
2024-10-06,文锦渡,出境,1209,726,4,1939
2024-10-06,沙头角,入境,0,0,0,0
2024-10-06,沙头角,出境,0,0,0,0
2024-10-06,深圳湾,入境,49674,14730,629,65033
2024-10-06,深圳湾,出境,34491,30354,2396,67241
2024-10-06,中国客运码头,入境,1125,752,38,1915
2024-10-06,中国客运码头,出境,418,974,65,1457
2024-10-06,港口管制,入境,0,0,54,54
2024-10-06,港口管制,出境,0,0,58,58
2024-10-06,启德邮轮码头,入境,0,0,0,0
2024-10-06,启德邮轮码头,出境,0,0,0,0
2024-10-06,港澳客轮码头,入境,5866,1562,2053,9481
2024-10-06,港澳客轮码头,出境,4473,2346,2760,9579
2024-10-07,机场,入境,20786,40031,12360,73177
2024-10-07,机场,出境,24867,10298,11729,46894
2024-10-07,高铁西九龙,入境,12698,11777,653,25128
2024-10-07,高铁西九龙,出境,13476,30693,1668,45837
2024-10-07,罗湖,入境,66073,11772,563,78408
2024-10-07,罗湖,出境,63120,19874,840,83834
2024-10-07,落马洲支线,入境,50476,14613,320,65409
2024-10-07,落马洲支线,出境,50834,20465,542,71841
2024-10-07,香园围,入境,25776,5865,120,31761
2024-10-07,香园围,出境,26291,7095,205,33591
2024-10-07,港珠澳大桥,入境,24179,4648,3329,32156
2024-10-07,港珠澳大桥,出境,22319,7194,2807,32320
2024-10-07,落马洲,入境,11597,2446,184,14227
2024-10-07,落马洲,出境,8952,12183,968,22103
2024-10-07,文锦渡,入境,2145,532,6,2683
2024-10-07,文锦渡,出境,2084,532,21,2637
2024-10-07,沙头角,入境,0,0,0,0
2024-10-07,沙头角,出境,0,0,0,0
2024-10-07,深圳湾,入境,26124,9663,561,36348
2024-10-07,深圳湾,出境,28492,28768,2239,59499
2024-10-07,中国客运码头,入境,628,784,56,1468
2024-10-07,中国客运码头,出境,625,761,67,1453
2024-10-07,港口管制,入境,0,0,66,66
2024-10-07,港口管制,出境,1,2,25,28
2024-10-07,启德邮轮码头,入境,213,3213,72,3498
2024-10-07,启德邮轮码头,出境,445,2281,111,2837
2024-10-07,港澳客轮码头,入境,4829,980,1766,7575
2024-10-07,港澳客轮码头,出境,5450,1278,2606,9334
2024-10-08,机场,入境,20974,27982,14563,63519
2024-10-08,机场,出境,27720,7380,10751,45851
2024-10-08,高铁西九龙,入境,12252,9333,859,22444
2024-10-08,高铁西九龙,出境,14107,11469,1480,27056
2024-10-08,罗湖,入境,66272,9649,549,76470
2024-10-08,罗湖,出境,67479,11483,783,79745
2024-10-08,落马洲支线,入境,51154,11301,299,62754
2024-10-08,落马洲支线,出境,55269,12132,453,67854
2024-10-08,香园围,入境,28011,3255,104,31370
2024-10-08,香园围,出境,28622,3352,259,32233
2024-10-08,港珠澳大桥,入境,18923,3132,2885,24940
2024-10-08,港珠澳大桥,出境,19901,4620,2872,27393
2024-10-08,落马洲,入境,9835,1670,174,11679
2024-10-08,落马洲,出境,9657,9626,777,20060
2024-10-08,文锦渡,入境,2056,343,9,2408
2024-10-08,文锦渡,出境,2079,334,12,2425
2024-10-08,沙头角,入境,0,0,0,0
2024-10-08,沙头角,出境,0,0,0,0
2024-10-08,深圳湾,入境,27470,7539,562,35571
2024-10-08,深圳湾,出境,29846,15056,1636,46538
2024-10-08,中国客运码头,入境,317,318,42,677
2024-10-08,中国客运码头,出境,531,249,70,850
2024-10-08,港口管制,入境,2,0,73,75
2024-10-08,港口管制,出境,2,0,38,40
2024-10-08,启德邮轮码头,入境,0,0,0,0
2024-10-08,启德邮轮码头,出境,0,0,0,0
2024-10-08,港澳客轮码头,入境,4764,550,1623,6937
2024-10-08,港澳客轮码头,出境,4924,737,2072,7733
2024-10-09,机场,入境,21995,17562,21356,60913
2024-10-09,机场,出境,37560,5367,11078,54005
2024-10-09,高铁西九龙,入境,11799,9759,784,22342
2024-10-09,高铁西九龙,出境,15746,10064,1365,27175
2024-10-09,罗湖,入境,65185,9984,555,75724
2024-10-09,罗湖,出境,67714,11538,738,79990
2024-10-09,落马洲支线,入境,51226,11399,334,62959
2024-10-09,落马洲支线,出境,54711,11630,440,66781
2024-10-09,香园围,入境,28087,5057,119,33263
2024-10-09,香园围,出境,28734,2809,202,31745
2024-10-09,港珠澳大桥,入境,18918,3087,2951,24956
2024-10-09,港珠澳大桥,出境,19804,4774,3027,27605
2024-10-09,落马洲,入境,10231,1782,243,12256
2024-10-09,落马洲,出境,9474,5828,672,15974
2024-10-09,文锦渡,入境,2005,385,11,2401
2024-10-09,文锦渡,出境,2041,364,8,2413
2024-10-09,沙头角,入境,0,0,0,0
2024-10-09,沙头角,出境,0,0,0,0
2024-10-09,深圳湾,入境,28586,7885,703,37174
2024-10-09,深圳湾,出境,31059,11914,1381,44354
2024-10-09,中国客运码头,入境,403,278,51,732
2024-10-09,中国客运码头,出境,463,281,46,790
2024-10-09,港口管制,入境,0,0,53,53
2024-10-09,港口管制,出境,0,0,60,60
2024-10-09,启德邮轮码头,入境,8,488,1,497
2024-10-09,启德邮轮码头,出境,8,480,1,489
2024-10-09,港澳客轮码头,入境,4970,550,1666,7186
2024-10-09,港澳客轮码头,出境,4650,644,2060,7354
2024-10-10,机场,入境,22835,11387,24270,58492
2024-10-10,机场,出境,54046,4103,10083,68232
2024-10-10,高铁西九龙,入境,12018,10731,935,23684
2024-10-10,高铁西九龙,出境,37898,9447,1474,48819
2024-10-10,罗湖,入境,66603,10096,658,77357
2024-10-10,罗湖,出境,117248,14129,934,132311
2024-10-10,落马洲支线,入境,51836,12481,342,64659
2024-10-10,落马洲支线,出境,92809,14612,537,107958
2024-10-10,香园围,入境,28490,6446,115,35051
2024-10-10,香园围,出境,39261,3428,253,42942
2024-10-10,港珠澳大桥,入境,19592,3492,3813,26897
2024-10-10,港珠澳大桥,出境,50009,6694,3452,60155
2024-10-10,落马洲,入境,10570,2651,251,13472
2024-10-10,落马洲,出境,16243,4959,564,21766
2024-10-10,文锦渡,入境,2019,422,21,2462
2024-10-10,文锦渡,出境,2696,363,3,3062
2024-10-10,沙头角,入境,0,0,0,0
2024-10-10,沙头角,出境,0,0,0,0
2024-10-10,深圳湾,入境,27906,11443,887,40236
2024-10-10,深圳湾,出境,59240,11141,1353,71734
2024-10-10,中国客运码头,入境,418,318,44,780
2024-10-10,中国客运码头,出境,1258,337,60,1655
2024-10-10,港口管制,入境,0,1,34,35
2024-10-10,港口管制,出境,83,0,49,132
2024-10-10,启德邮轮码头,入境,0,0,0,0
2024-10-10,启德邮轮码头,出境,0,0,0,0
2024-10-10,港澳客轮码头,入境,5352,585,2641,8578
2024-10-10,港澳客轮码头,出境,8815,836,2974,12625
2024-10-11,机场,入境,26373,7412,23327,57112
2024-10-11,机场,出境,48410,4437,11412,64259
2024-10-11,高铁西九龙,入境,15957,9051,1145,26153
2024-10-11,高铁西九龙,出境,45448,8746,1409,55603
2024-10-11,罗湖,入境,109753,8816,675,119244
2024-10-11,罗湖,出境,139102,10713,975,150790
2024-10-11,落马洲支线,入境,87579,10624,375,98578
2024-10-11,落马洲支线,出境,128745,10982,460,140187
2024-10-11,香园围,入境,38261,5796,109,44166
2024-10-11,香园围,出境,51016,2613,313,53942
2024-10-11,港珠澳大桥,入境,33864,3452,7382,44698
2024-10-11,港珠澳大桥,出境,69239,7862,6244,83345
2024-10-11,落马洲,入境,22925,2014,443,25382
2024-10-11,落马洲,出境,23464,2997,562,27023
2024-10-11,文锦渡,入境,1843,380,7,2230
2024-10-11,文锦渡,出境,3004,389,10,3403
2024-10-11,沙头角,入境,0,0,0,0
2024-10-11,沙头角,出境,0,0,0,0
2024-10-11,深圳湾,入境,46283,8022,1040,55345
2024-10-11,深圳湾,出境,75082,7546,1410,84038
2024-10-11,中国客运码头,入境,426,236,58,720
2024-10-11,中国客运码头,出境,2471,228,37,2736
2024-10-11,港口管制,入境,0,0,14,14
2024-10-11,港口管制,出境,0,0,37,37
2024-10-11,启德邮轮码头,入境,0,0,0,0
2024-10-11,启德邮轮码头,出境,0,0,0,0
2024-10-11,港澳客轮码头,入境,7620,575,3450,11645
2024-10-11,港澳客轮码头,出境,12696,763,3486,16945
2024-10-12,机场,入境,35274,6635,24476,66385
2024-10-12,机场,出境,26844,5135,17502,49481
2024-10-12,高铁西九龙,入境,22009,13908,1646,37563
2024-10-12,高铁西九龙,出境,18338,11251,1859,31448
2024-10-12,罗湖,入境,92477,10757,910,104144
2024-10-12,罗湖,出境,87569,11748,956,100273
2024-10-12,落马洲支线,入境,76209,13742,550,90501
2024-10-12,落马洲支线,出境,77801,12693,531,91025
2024-10-12,香园围,入境,36143,9308,187,45638
2024-10-12,香园围,出境,36094,4883,369,41346
2024-10-12,港珠澳大桥,入境,44207,4149,5319,53675
2024-10-12,港珠澳大桥,出境,33107,7691,5306,46104
2024-10-12,落马洲,入境,23386,2919,518,26823
2024-10-12,落马洲,出境,15351,3339,462,19152
2024-10-12,文锦渡,入境,1567,462,14,2043
2024-10-12,文锦渡,出境,1877,427,9,2313
2024-10-12,沙头角,入境,0,0,0,0
2024-10-12,沙头角,出境,0,0,0,0
2024-10-12,深圳湾,入境,48531,12368,1083,61982
2024-10-12,深圳湾,出境,41455,9590,1354,52399
2024-10-12,中国客运码头,入境,804,500,72,1376
2024-10-12,中国客运码头,出境,634,301,33,968
2024-10-12,港口管制,入境,0,0,41,41
2024-10-12,港口管制,出境,77,0,11,88
2024-10-12,启德邮轮码头,入境,446,2282,95,2823
2024-10-12,启德邮轮码头,出境,89,3035,66,3190
2024-10-12,港澳客轮码头,入境,9582,692,3330,13604
2024-10-12,港澳客轮码头,出境,7701,805,3736,12242
2024-10-13,机场,入境,57519,5417,16377,79313
2024-10-13,机场,出境,27717,5321,24524,57562
2024-10-13,高铁西九龙,入境,44940,15343,1277,61560
2024-10-13,高铁西九龙,出境,11057,15381,2244,28682
2024-10-13,罗湖,入境,125654,15044,1020,141718
2024-10-13,罗湖,出境,54931,16362,928,72221
2024-10-13,落马洲支线,入境,99907,20356,568,120831
2024-10-13,落马洲支线,出境,45356,19060,576,64992
2024-10-13,香园围,入境,42339,11374,137,53850
2024-10-13,香园围,出境,22668,5046,261,27975
2024-10-13,港珠澳大桥,入境,68573,4990,4918,78481
2024-10-13,港珠澳大桥,出境,20519,8055,5066,33640
2024-10-13,落马洲,入境,28561,2927,411,31899
2024-10-13,落马洲,出境,9878,3129,620,13627
2024-10-13,文锦渡,入境,2684,577,12,3273
2024-10-13,文锦渡,出境,1096,431,11,1538
2024-10-13,沙头角,入境,0,0,0,0
2024-10-13,沙头角,出境,0,0,0,0
2024-10-13,深圳湾,入境,82602,13554,1017,97173
2024-10-13,深圳湾,出境,26621,11851,1769,40241
2024-10-13,中国客运码头,入境,2972,381,46,3399
2024-10-13,中国客运码头,出境,300,351,70,721
2024-10-13,港口管制,入境,18,0,7,25
2024-10-13,港口管制,出境,0,0,9,9
2024-10-13,启德邮轮码头,入境,0,0,0,0
2024-10-13,启德邮轮码头,出境,0,0,0,0
2024-10-13,港澳客轮码头,入境,12646,762,2785,16193
2024-10-13,港澳客轮码头,出境,5117,916,4172,10205
2024-10-14,机场,入境,46593,7507,18822,72922
2024-10-14,机场,出境,27418,5447,22528,55393
2024-10-14,高铁西九龙,入境,21047,15104,1528,37679
2024-10-14,高铁西九龙,出境,14391,13764,4372,32527
2024-10-14,罗湖,入境,73330,12990,963,87283
2024-10-14,罗湖,出境,65179,13035,1170,79384
2024-10-14,落马洲支线,入境,58104,13335,497,71936
2024-10-14,落马洲支线,出境,54657,11948,586,67191
2024-10-14,香园围,入境,29244,11133,242,40619
2024-10-14,香园围,出境,28518,3282,272,32072
2024-10-14,港珠澳大桥,入境,24116,4283,4056,32455
2024-10-14,港珠澳大桥,出境,19241,9329,3262,31832
2024-10-14,落马洲,入境,13161,2919,361,16441
2024-10-14,落马洲,出境,9026,4274,1009,14309
2024-10-14,文锦渡,入境,2110,437,11,2558
2024-10-14,文锦渡,出境,1995,388,27,2410
2024-10-14,沙头角,入境,0,0,0,0
2024-10-14,沙头角,出境,0,0,0,0
2024-10-14,深圳湾,入境,34985,10144,1067,46196
2024-10-14,深圳湾,出境,29431,12809,3077,45317
2024-10-14,中国客运码头,入境,580,447,40,1067
2024-10-14,中国客运码头,出境,461,355,150,966
2024-10-14,港口管制,入境,19,0,40,59
2024-10-14,港口管制,出境,3,0,33,36
2024-10-14,启德邮轮码头,入境,0,0,0,0
2024-10-14,启德邮轮码头,出境,0,0,0,0
2024-10-14,港澳客轮码头,入境,5748,898,2218,8864
2024-10-14,港澳客轮码头,出境,4819,949,3103,8871
